PokerStars Zoom Hand #216382773673:  Hold'em No Limit ($0.01/$0.02) - 2020/07/13 19:18:24 CET [2020/07/13 13:18:24 ET]
Table 'McNaught' 9-max Seat #1 is the button
Seat 1: GaliRah ($2.13 in chips) 
Seat 2: linkk1075 ($6.01 in chips) 
Seat 3: TrankTank ($2 in chips) 
Seat 4: Dows&Poker ($2.31 in chips) 
Seat 5: TheBlade8525 ($5.05 in chips) 
Seat 6: canxuh ($2.32 in chips) 
Seat 7: STYNG01 ($15.31 in chips) 
Seat 8: AniArun ($1.42 in chips) 
Seat 9: BONECA DELICADA ($1.23 in chips) 
linkk1075: posts small blind $0.01
TrankTank: posts big blind $0.02
*** HOLE CARDS ***
Dealt to TrankTank [Qs 7c]
Dows&Poker: folds 
TheBlade8525: folds 
canxuh: folds 
STYNG01: calls $0.02
AniArun: folds 
BONECA DELICADA: folds 
GaliRah: folds 
linkk1075: folds 
TrankTank: checks 
*** FLOP *** [Qc Kd 5c]
TrankTank: bets $0.03
STYNG01: calls $0.03
*** TURN *** [Qc Kd 5c] [Qd]
TrankTank: bets $0.08
STYNG01: calls $0.08
*** RIVER *** [Qc Kd 5c Qd] [9s]
TrankTank: bets $0.18
STYNG01: calls $0.18
*** SHOW DOWN ***
TrankTank: shows [Qs 7c] (three of a kind, Queens)
STYNG01: shows [Jc Qh] (three of a kind, Queens - King+Jack kicker)
STYNG01 collected $0.61 from pot
*** SUMMARY ***
Total pot $0.63 | Rake $0.02 
Board [Qc Kd 5c Qd 9s]
Seat 1: GaliRah (button) folded before Flop (didn't bet)
Seat 2: linkk1075 (small blind) folded before Flop
Seat 3: TrankTank (big blind) showed [Qs 7c] and lost with three of a kind, Queens
Seat 4: Dows&Poker folded before Flop (didn't bet)
Seat 5: TheBlade8525 folded before Flop (didn't bet)
Seat 6: canxuh folded before Flop (didn't bet)
Seat 7: STYNG01 showed [Jc Qh] and won ($0.61) with three of a kind, Queens
Seat 8: AniArun folded before Flop (didn't bet)
Seat 9: BONECA DELICADA folded before Flop (didn't bet)



PokerStars Zoom Hand #216382805584:  Hold'em No Limit ($0.01/$0.02) - 2020/07/13 19:19:24 CET [2020/07/13 13:19:24 ET]
Table 'McNaught' 9-max Seat #1 is the button
Seat 1: patkosmpa ($1.77 in chips) 
Seat 2: Shaman_Old ($0.82 in chips) 
Seat 3: gersomen2791 ($2.54 in chips) 
Seat 4: papatomi4 ($1.72 in chips) 
Seat 5: gloommyrat ($3.65 in chips) 
Seat 6: skorilo ($2.78 in chips) 
Seat 7: pocoyo088 ($2 in chips) 
Seat 8: TrankTank ($2 in chips) 
Seat 9: TheBlade8525 ($5.10 in chips) 
Shaman_Old: posts small blind $0.01
gersomen2791: posts big blind $0.02
*** HOLE CARDS ***
Dealt to TrankTank [Kd 6d]
papatomi4: folds 
gloommyrat: folds 
skorilo: calls $0.02
pocoyo088: folds 
TrankTank: folds 
TheBlade8525: folds 
patkosmpa: folds 
Shaman_Old: calls $0.01
gersomen2791: checks 
*** FLOP *** [Td 7h 8d]
Shaman_Old: bets $0.04
gersomen2791: folds 
skorilo: calls $0.04
*** TURN *** [Td 7h 8d] [4c]
Shaman_Old: bets $0.04
skorilo: calls $0.04
*** RIVER *** [Td 7h 8d 4c] [2d]
Shaman_Old: checks 
skorilo: bets $0.21
Shaman_Old: folds 
Uncalled bet ($0.21) returned to skorilo
skorilo collected $0.21 from pot
skorilo: doesn't show hand 
*** SUMMARY ***
Total pot $0.22 | Rake $0.01 
Board [Td 7h 8d 4c 2d]
Seat 1: patkosmpa (button) folded before Flop (didn't bet)
Seat 2: Shaman_Old (small blind) folded on the River
Seat 3: gersomen2791 (big blind) folded on the Flop
Seat 4: papatomi4 folded before Flop (didn't bet)
Seat 5: gloommyrat folded before Flop (didn't bet)
Seat 6: skorilo collected ($0.21)
Seat 7: pocoyo088 folded before Flop (didn't bet)
Seat 8: TrankTank folded before Flop (didn't bet)
Seat 9: TheBlade8525 folded before Flop (didn't bet)



PokerStars Zoom Hand #216382813002:  Hold'em No Limit ($0.01/$0.02) - 2020/07/13 19:19:38 CET [2020/07/13 13:19:38 ET]
Table 'McNaught' 9-max Seat #1 is the button
Seat 1: TrankTank ($2 in chips) 
Seat 2: nenuki-melide ($1.64 in chips) 
Seat 3: ega2002321 ($2 in chips) 
Seat 4: red_81_2009 ($1.96 in chips) 
Seat 5: Krimil ($0.73 in chips) 
Seat 6: Dows&Poker ($2.45 in chips) 
Seat 7: pocoyo088 ($2.03 in chips) 
Seat 8: hurla64 ($2.23 in chips) 
Seat 9: pumpedli ($2.22 in chips) 
nenuki-melide: posts small blind $0.01
ega2002321: posts big blind $0.02
*** HOLE CARDS ***
Dealt to TrankTank [8s 9s]
red_81_2009: calls $0.02
Krimil: raises $0.02 to $0.04
ega2002321 is disconnected 
Dows&Poker: folds 
pocoyo088: folds 
hurla64: folds 
pumpedli: folds 
TrankTank: calls $0.04
nenuki-melide: folds 
ega2002321: folds 
red_81_2009: calls $0.02
*** FLOP *** [Qh 6c Jh]
red_81_2009: checks 
Krimil: checks 
TrankTank: checks 
*** TURN *** [Qh 6c Jh] [5h]
red_81_2009: checks 
Krimil: checks 
TrankTank: checks 
*** RIVER *** [Qh 6c Jh 5h] [4c]
red_81_2009: bets $0.06
Krimil: folds 
TrankTank: folds 
Uncalled bet ($0.06) returned to red_81_2009
red_81_2009 collected $0.14 from pot
red_81_2009: doesn't show hand 
*** SUMMARY ***
Total pot $0.15 | Rake $0.01 
Board [Qh 6c Jh 5h 4c]
Seat 1: TrankTank (button) folded on the River
Seat 2: nenuki-melide (small blind) folded before Flop
Seat 3: ega2002321 (big blind) folded before Flop
Seat 4: red_81_2009 collected ($0.14)
Seat 5: Krimil folded on the River
Seat 6: Dows&Poker folded before Flop (didn't bet)
Seat 7: pocoyo088 folded before Flop (didn't bet)
Seat 8: hurla64 folded before Flop (didn't bet)
Seat 9: pumpedli folded before Flop (didn't bet)



PokerStars Zoom Hand #216382841588:  Hold'em No Limit ($0.01/$0.02) - 2020/07/13 19:20:31 CET [2020/07/13 13:20:31 ET]
Table 'McNaught' 9-max Seat #1 is the button
Seat 1: feschkel ($2.08 in chips) 
Seat 2: TrankTank ($2 in chips) 
Seat 3: Mara6111 ($3.44 in chips) 
Seat 4: wraggy225 ($0.36 in chips) 
Seat 5: pumpedli ($2.37 in chips) 
Seat 6: patkosmpa ($1.77 in chips) 
Seat 7: gloommyrat ($2.75 in chips) 
Seat 8: bogdan_k_ua ($1.17 in chips) 
Seat 9: hurla64 ($12.02 in chips) 
TrankTank: posts small blind $0.01
Mara6111: posts big blind $0.02
*** HOLE CARDS ***
Dealt to TrankTank [7d 8c]
wraggy225: folds 
pumpedli: folds 
patkosmpa: folds 
gloommyrat: folds 
bogdan_k_ua: folds 
hurla64: folds 
feschkel: raises $0.10 to $0.12
TrankTank: folds 
Mara6111: folds 
Uncalled bet ($0.10) returned to feschkel
feschkel collected $0.05 from pot
feschkel: doesn't show hand 
*** SUMMARY ***
Total pot $0.05 | Rake $0 
Seat 1: feschkel (button) collected ($0.05)
Seat 2: TrankTank (small blind) folded before Flop
Seat 3: Mara6111 (big blind) folded before Flop
Seat 4: wraggy225 folded before Flop (didn't bet)
Seat 5: pumpedli folded before Flop (didn't bet)
Seat 6: patkosmpa folded before Flop (didn't bet)
Seat 7: gloommyrat folded before Flop (didn't bet)
Seat 8: bogdan_k_ua folded before Flop (didn't bet)
Seat 9: hurla64 folded before Flop (didn't bet)



PokerStars Zoom Hand #216382853233:  Hold'em No Limit ($0.01/$0.02) - 2020/07/13 19:20:53 CET [2020/07/13 13:20:53 ET]
Table 'McNaught' 9-max Seat #1 is the button
Seat 1: XHerrTUMNUSX ($4.69 in chips) 
Seat 2: bogdan_k_ua ($1.17 in chips) 
Seat 3: snow9001 ($2.38 in chips) 
Seat 4: gloommyrat ($2.75 in chips) 
Seat 5: Hyperboreus ($2.01 in chips) 
Seat 6: Mizepa ($2 in chips) 
Seat 7: wraggy225 ($2.20 in chips) 
Seat 8: alosksora ($2.48 in chips) 
Seat 9: TrankTank ($2 in chips) 
bogdan_k_ua: posts small blind $0.01
snow9001: posts big blind $0.02
*** HOLE CARDS ***
Dealt to TrankTank [8d 5c]
gloommyrat: folds 
Hyperboreus: folds 
Mizepa: raises $0.04 to $0.06
wraggy225: folds 
alosksora: folds 
TrankTank: folds 
XHerrTUMNUSX: folds 
bogdan_k_ua: folds 
snow9001: folds 
Uncalled bet ($0.04) returned to Mizepa
Mizepa collected $0.05 from pot
Mizepa: doesn't show hand 
*** SUMMARY ***
Total pot $0.05 | Rake $0 
Seat 1: XHerrTUMNUSX (button) folded before Flop (didn't bet)
Seat 2: bogdan_k_ua (small blind) folded before Flop
Seat 3: snow9001 (big blind) folded before Flop
Seat 4: gloommyrat folded before Flop (didn't bet)
Seat 5: Hyperboreus folded before Flop (didn't bet)
Seat 6: Mizepa collected ($0.05)
Seat 7: wraggy225 folded before Flop (didn't bet)
Seat 8: alosksora folded before Flop (didn't bet)
Seat 9: TrankTank folded before Flop (didn't bet)



PokerStars Zoom Hand #216382861933:  Hold'em No Limit ($0.01/$0.02) - 2020/07/13 19:21:09 CET [2020/07/13 13:21:09 ET]
Table 'McNaught' 9-max Seat #1 is the button
Seat 1: Aveena2 ($2.23 in chips) 
Seat 2: niko16321 ($1 in chips) 
Seat 3: TheBlade8525 ($4.77 in chips) 
Seat 4: red_81_2009 ($1.62 in chips) 
Seat 5: J0SHB0SH ($2.38 in chips) 
Seat 6: TrankTank ($2 in chips) 
Seat 7: givinfree$ ($2.61 in chips) 
Seat 8: gloommyrat ($9.16 in chips) 
Seat 9: STYNG01 ($5.92 in chips) 
niko16321: posts small blind $0.01
TheBlade8525: posts big blind $0.02
*** HOLE CARDS ***
Dealt to TrankTank [Ks 7s]
red_81_2009: folds 
J0SHB0SH: folds 
TrankTank: folds 
givinfree$: folds 
gloommyrat: folds 
STYNG01: folds 
Aveena2: folds 
niko16321: folds 
Uncalled bet ($0.01) returned to TheBlade8525
TheBlade8525 collected $0.02 from pot
TheBlade8525: doesn't show hand 
*** SUMMARY ***
Total pot $0.02 | Rake $0 
Seat 1: Aveena2 (button) folded before Flop (didn't bet)
Seat 2: niko16321 (small blind) folded before Flop
Seat 3: TheBlade8525 (big blind) collected ($0.02)
Seat 4: red_81_2009 folded before Flop (didn't bet)
Seat 5: J0SHB0SH folded before Flop (didn't bet)
Seat 6: TrankTank folded before Flop (didn't bet)
Seat 7: givinfree$ folded before Flop (didn't bet)
Seat 8: gloommyrat folded before Flop (didn't bet)
Seat 9: STYNG01 folded before Flop (didn't bet)



PokerStars Zoom Hand #216382871675:  Hold'em No Limit ($0.01/$0.02) - 2020/07/13 19:21:27 CET [2020/07/13 13:21:27 ET]
Table 'McNaught' 9-max Seat #1 is the button
Seat 1: AniArun ($1.05 in chips) 
Seat 2: BadBeat Bert ($3.04 in chips) 
Seat 3: pisqnek ($4.32 in chips) 
Seat 4: EliFilho55 ($1.95 in chips) 
Seat 5: TrankTank ($2 in chips) 
Seat 6: STYNG01 ($15.88 in chips) 
Seat 7: patkosmpa ($2.06 in chips) 
Seat 8: red_81_2009 ($2 in chips) 
Seat 9: Dows&Poker ($2.30 in chips) 
BadBeat Bert: posts small blind $0.01
pisqnek: posts big blind $0.02
*** HOLE CARDS ***
Dealt to TrankTank [9h 2d]
EliFilho55: folds 
TrankTank: folds 
STYNG01: folds 
patkosmpa: raises $0.04 to $0.06
red_81_2009: folds 
Dows&Poker: folds 
AniArun: folds 
BadBeat Bert: folds 
pisqnek: folds 
Uncalled bet ($0.04) returned to patkosmpa
patkosmpa collected $0.05 from pot
patkosmpa: doesn't show hand 
*** SUMMARY ***
Total pot $0.05 | Rake $0 
Seat 1: AniArun (button) folded before Flop (didn't bet)
Seat 2: BadBeat Bert (small blind) folded before Flop
Seat 3: pisqnek (big blind) folded before Flop
Seat 4: EliFilho55 folded before Flop (didn't bet)
Seat 5: TrankTank folded before Flop (didn't bet)
Seat 6: STYNG01 folded before Flop (didn't bet)
Seat 7: patkosmpa collected ($0.05)
Seat 8: red_81_2009 folded before Flop (didn't bet)
Seat 9: Dows&Poker folded before Flop (didn't bet)



PokerStars Zoom Hand #216382858664:  Hold'em No Limit ($0.01/$0.02) - 2020/07/13 19:21:03 CET [2020/07/13 13:21:03 ET]
Table 'McNaught' 9-max Seat #1 is the button
Seat 1: snow9001 ($2.50 in chips) 
Seat 2: Mara6111 ($3.42 in chips) 
Seat 3: alexburton24 ($5.19 in chips) 
Seat 4: TrankTank ($2 in chips) 
Seat 5: Selckinto ($2.07 in chips) 
Seat 6: hübispliff ($4.77 in chips) 
Seat 7: ggGoldenPunk ($1.90 in chips) 
Seat 8: STYNG01 ($8.36 in chips) 
Seat 9: feschkel ($2.10 in chips) 
Mara6111: posts small blind $0.01
alexburton24: posts big blind $0.02
*** HOLE CARDS ***
Dealt to TrankTank [2c Kd]
TrankTank: folds 
Selckinto: folds 
hübispliff: folds 
ggGoldenPunk: folds 
STYNG01: folds 
feschkel: calls $0.02
snow9001: folds 
Mara6111: folds 
alexburton24: checks 
*** FLOP *** [As 8d 2d]
alexburton24: checks 
feschkel: checks 
*** TURN *** [As 8d 2d] [6s]
alexburton24: checks 
feschkel: bets $0.05
alexburton24: calls $0.05
*** RIVER *** [As 8d 2d 6s] [9d]
alexburton24: checks 
feschkel: bets $0.07
alexburton24: folds 
Uncalled bet ($0.07) returned to feschkel
feschkel collected $0.14 from pot
feschkel: doesn't show hand 
*** SUMMARY ***
Total pot $0.15 | Rake $0.01 
Board [As 8d 2d 6s 9d]
Seat 1: snow9001 (button) folded before Flop (didn't bet)
Seat 2: Mara6111 (small blind) folded before Flop
Seat 3: alexburton24 (big blind) folded on the River
Seat 4: TrankTank folded before Flop (didn't bet)
Seat 5: Selckinto folded before Flop (didn't bet)
Seat 6: hübispliff folded before Flop (didn't bet)
Seat 7: ggGoldenPunk folded before Flop (didn't bet)
Seat 8: STYNG01 folded before Flop (didn't bet)
Seat 9: feschkel collected ($0.14)



PokerStars Zoom Hand #216382868447:  Hold'em No Limit ($0.01/$0.02) - 2020/07/13 19:21:21 CET [2020/07/13 13:21:21 ET]
Table 'McNaught' 9-max Seat #1 is the button
Seat 1: Mara6111 ($3.41 in chips) 
Seat 2: pisqnek ($4.33 in chips) 
Seat 3: smoke1ne ($3.46 in chips) 
Seat 4: gloommyrat ($9.16 in chips) 
Seat 5: J0SHB0SH ($2 in chips) 
Seat 6: Aveena2 ($2.13 in chips) 
Seat 7: TrankTank ($2 in chips) 
Seat 8: MaksDoos ($0.70 in chips) 
Seat 9: BLEF1973 ($11.66 in chips) 
pisqnek: posts small blind $0.01
smoke1ne: posts big blind $0.02
*** HOLE CARDS ***
Dealt to TrankTank [6s 5h]
gloommyrat: folds 
J0SHB0SH: folds 
Aveena2: folds 
TrankTank: folds 
MaksDoos: folds 
BLEF1973: folds 
Mara6111: calls $0.02
pisqnek: folds 
smoke1ne: checks 
*** FLOP *** [Kh Qh 5c]
smoke1ne: checks 
Mara6111: bets $0.02
smoke1ne: folds 
Uncalled bet ($0.02) returned to Mara6111
Mara6111 collected $0.05 from pot
Mara6111: doesn't show hand 
*** SUMMARY ***
Total pot $0.05 | Rake $0 
Board [Kh Qh 5c]
Seat 1: Mara6111 (button) collected ($0.05)
Seat 2: pisqnek (small blind) folded before Flop
Seat 3: smoke1ne (big blind) folded on the Flop
Seat 4: gloommyrat folded before Flop (didn't bet)
Seat 5: J0SHB0SH folded before Flop (didn't bet)
Seat 6: Aveena2 folded before Flop (didn't bet)
Seat 7: TrankTank folded before Flop (didn't bet)
Seat 8: MaksDoos folded before Flop (didn't bet)
Seat 9: BLEF1973 folded before Flop (didn't bet)



PokerStars Zoom Hand #216382886824:  Hold'em No Limit ($0.01/$0.02) - 2020/07/13 19:21:55 CET [2020/07/13 13:21:55 ET]
Table 'McNaught' 9-max Seat #1 is the button
Seat 1: tonormz23 ($5.65 in chips) 
Seat 2: papatomi4 ($2.35 in chips) 
Seat 3: TrankTank ($2 in chips) 
Seat 4: AleTiagoAle ($1.32 in chips) 
Seat 5: givinfree$ ($4.57 in chips) 
Seat 6: Dows&Poker ($2.44 in chips) 
Seat 7: red_81_2009 ($1.62 in chips) 
Seat 8: BONECA DELICADA ($1.97 in chips) 
Seat 9: pocoyo088 ($2 in chips) 
papatomi4: posts small blind $0.01
TrankTank: posts big blind $0.02
*** HOLE CARDS ***
Dealt to TrankTank [Jc 3d]
AleTiagoAle: folds 
givinfree$: folds 
Dows&Poker: folds 
red_81_2009: raises $0.04 to $0.06
BONECA DELICADA: folds 
pocoyo088: folds 
tonormz23: folds 
papatomi4: folds 
TrankTank: folds 
Uncalled bet ($0.04) returned to red_81_2009
red_81_2009 collected $0.05 from pot
red_81_2009: doesn't show hand 
*** SUMMARY ***
Total pot $0.05 | Rake $0 
Seat 1: tonormz23 (button) folded before Flop (didn't bet)
Seat 2: papatomi4 (small blind) folded before Flop
Seat 3: TrankTank (big blind) folded before Flop
Seat 4: AleTiagoAle folded before Flop (didn't bet)
Seat 5: givinfree$ folded before Flop (didn't bet)
Seat 6: Dows&Poker folded before Flop (didn't bet)
Seat 7: red_81_2009 collected ($0.05)
Seat 8: BONECA DELICADA folded before Flop (didn't bet)
Seat 9: pocoyo088 folded before Flop (didn't bet)



PokerStars Zoom Hand #216382878721:  Hold'em No Limit ($0.01/$0.02) - 2020/07/13 19:21:40 CET [2020/07/13 13:21:40 ET]
Table 'McNaught' 9-max Seat #1 is the button
Seat 1: wraggy225 ($2.02 in chips) 
Seat 2: hurla64 ($5.77 in chips) 
Seat 3: WilFred.ru ($2 in chips) 
Seat 4: MaksDoos ($0.69 in chips) 
Seat 5: OMG EinClown ($2.09 in chips) 
Seat 6: TrankTank ($2 in chips) 
Seat 7: gloommyrat ($4.14 in chips) 
Seat 8: Elvis ah ha ($2.43 in chips) 
Seat 9: J0SHB0SH ($2 in chips) 
hurla64: posts small blind $0.01
WilFred.ru: posts big blind $0.02
*** HOLE CARDS ***
Dealt to TrankTank [6s 4d]
MaksDoos: folds 
OMG EinClown: folds 
TrankTank: folds 
gloommyrat: folds 
Elvis ah ha: folds 
J0SHB0SH: raises $0.02 to $0.04
wraggy225: folds 
hurla64: folds 
WilFred.ru: calls $0.02
*** FLOP *** [9s As 2c]
WilFred.ru: checks 
J0SHB0SH: bets $0.04
WilFred.ru: folds 
Uncalled bet ($0.04) returned to J0SHB0SH
J0SHB0SH collected $0.09 from pot
J0SHB0SH: doesn't show hand 
*** SUMMARY ***
Total pot $0.09 | Rake $0 
Board [9s As 2c]
Seat 1: wraggy225 (button) folded before Flop (didn't bet)
Seat 2: hurla64 (small blind) folded before Flop
Seat 3: WilFred.ru (big blind) folded on the Flop
Seat 4: MaksDoos folded before Flop (didn't bet)
Seat 5: OMG EinClown folded before Flop (didn't bet)
Seat 6: TrankTank folded before Flop (didn't bet)
Seat 7: gloommyrat folded before Flop (didn't bet)
Seat 8: Elvis ah ha folded before Flop (didn't bet)
Seat 9: J0SHB0SH collected ($0.09)



PokerStars Zoom Hand #216382900962:  Hold'em No Limit ($0.01/$0.02) - 2020/07/13 19:22:21 CET [2020/07/13 13:22:21 ET]
Table 'McNaught' 9-max Seat #1 is the button
Seat 1: hurla64 ($5.76 in chips) 
Seat 2: Armtone ($2.80 in chips) 
Seat 3: Elvis ah ha ($2.40 in chips) 
Seat 4: GrafGo999 ($1.96 in chips) 
Seat 5: BONECA DELICADA ($1.14 in chips) 
Seat 6: bogdan_k_ua ($1.24 in chips) 
Seat 7: Nimajuan ($1.63 in chips) 
Seat 8: jackbam993 ($1.86 in chips) 
Seat 9: TrankTank ($2 in chips) 
Armtone: posts small blind $0.01
Elvis ah ha: posts big blind $0.02
*** HOLE CARDS ***
Dealt to TrankTank [4s 6d]
GrafGo999: folds 
BONECA DELICADA: folds 
bogdan_k_ua: folds 
Nimajuan: raises $0.08 to $0.10
jackbam993: folds 
TrankTank: folds 
hurla64: folds 
Armtone: folds 
Elvis ah ha: calls $0.08
*** FLOP *** [Th Kd Td]
Elvis ah ha: checks 
Nimajuan: checks 
*** TURN *** [Th Kd Td] [Tc]
Elvis ah ha: bets $0.10
Nimajuan: folds 
Uncalled bet ($0.10) returned to Elvis ah ha
Elvis ah ha collected $0.20 from pot
Elvis ah ha: doesn't show hand 
Nimajuan is disconnected 
*** SUMMARY ***
Total pot $0.21 | Rake $0.01 
Board [Th Kd Td Tc]
Seat 1: hurla64 (button) folded before Flop (didn't bet)
Seat 2: Armtone (small blind) folded before Flop
Seat 3: Elvis ah ha (big blind) collected ($0.20)
Seat 4: GrafGo999 folded before Flop (didn't bet)
Seat 5: BONECA DELICADA folded before Flop (didn't bet)
Seat 6: bogdan_k_ua folded before Flop (didn't bet)
Seat 7: Nimajuan folded on the Turn
Seat 8: jackbam993 folded before Flop (didn't bet)
Seat 9: TrankTank folded before Flop (didn't bet)



PokerStars Zoom Hand #216382908584:  Hold'em No Limit ($0.01/$0.02) - 2020/07/13 19:22:35 CET [2020/07/13 13:22:35 ET]
Table 'McNaught' 9-max Seat #1 is the button
Seat 1: hübispliff ($4.73 in chips) 
Seat 2: TrankTank ($2 in chips) 
Seat 3: bugsbunnies ($1.79 in chips) 
Seat 4: irenvik ($1.05 in chips) 
Seat 5: canxuh ($2.04 in chips) 
Seat 6: givinfree$ ($2.53 in chips) 
Seat 7: BLEF1973 ($11.69 in chips) 
Seat 8: pisqnek ($2.56 in chips) 
Seat 9: Dows&Poker ($2.33 in chips) 
TrankTank: posts small blind $0.01
bugsbunnies: posts big blind $0.02
*** HOLE CARDS ***
Dealt to TrankTank [Kh Td]
irenvik: folds 
canxuh: folds 
givinfree$: raises $0.04 to $0.06
BLEF1973: calls $0.06
pisqnek: folds 
Dows&Poker: folds 
hübispliff: calls $0.06
TrankTank: folds 
bugsbunnies: folds 
*** FLOP *** [2d 4d Tc]
givinfree$: checks 
BLEF1973: checks 
hübispliff: bets $0.06
givinfree$: folds 
BLEF1973: folds 
Uncalled bet ($0.06) returned to hübispliff
hübispliff collected $0.20 from pot
hübispliff: doesn't show hand 
*** SUMMARY ***
Total pot $0.21 | Rake $0.01 
Board [2d 4d Tc]
Seat 1: hübispliff (button) collected ($0.20)
Seat 2: TrankTank (small blind) folded before Flop
Seat 3: bugsbunnies (big blind) folded before Flop
Seat 4: irenvik folded before Flop (didn't bet)
Seat 5: canxuh folded before Flop (didn't bet)
Seat 6: givinfree$ folded on the Flop
Seat 7: BLEF1973 folded on the Flop
Seat 8: pisqnek folded before Flop (didn't bet)
Seat 9: Dows&Poker folded before Flop (didn't bet)



PokerStars Zoom Hand #216382928645:  Hold'em No Limit ($0.01/$0.02) - 2020/07/13 19:23:12 CET [2020/07/13 13:23:12 ET]
Table 'McNaught' 9-max Seat #1 is the button
Seat 1: grunge&punk ($0.55 in chips) 
Seat 2: pumpedli ($2.01 in chips) 
Seat 3: AndronDJ ($4.60 in chips) 
Seat 4: wraggy225 ($2.28 in chips) 
Seat 5: Armtone ($2.77 in chips) 
Seat 6: bogdan_k_ua ($1.30 in chips) 
Seat 7: TrankTank ($2 in chips) 
Seat 8: GrafGo999 ($4.31 in chips) 
Seat 9: red_81_2009 ($2.06 in chips) 
pumpedli: posts small blind $0.01
AndronDJ: posts big blind $0.02
*** HOLE CARDS ***
Dealt to TrankTank [Th 9c]
wraggy225: folds 
Armtone: folds 
bogdan_k_ua: folds 
TrankTank: folds 
GrafGo999: folds 
red_81_2009: folds 
grunge&punk: folds 
pumpedli: folds 
Uncalled bet ($0.01) returned to AndronDJ
AndronDJ collected $0.02 from pot
AndronDJ: doesn't show hand 
*** SUMMARY ***
Total pot $0.02 | Rake $0 
Seat 1: grunge&punk (button) folded before Flop (didn't bet)
Seat 2: pumpedli (small blind) folded before Flop
Seat 3: AndronDJ (big blind) collected ($0.02)
Seat 4: wraggy225 folded before Flop (didn't bet)
Seat 5: Armtone folded before Flop (didn't bet)
Seat 6: bogdan_k_ua folded before Flop (didn't bet)
Seat 7: TrankTank folded before Flop (didn't bet)
Seat 8: GrafGo999 folded before Flop (didn't bet)
Seat 9: red_81_2009 folded before Flop (didn't bet)



PokerStars Zoom Hand #216382911342:  Hold'em No Limit ($0.01/$0.02) - 2020/07/13 19:22:40 CET [2020/07/13 13:22:40 ET]
Table 'McNaught' 9-max Seat #1 is the button
Seat 1: TrankTank ($2 in chips) 
Seat 2: hurla64 ($5.09 in chips) 
Seat 3: linkk1075 ($8.41 in chips) 
Seat 4: irenvik ($1.05 in chips) 
Seat 5: pisqnek ($2.56 in chips) 
Seat 6: GrafGo999 ($4.31 in chips) 
Seat 7: 5gdangers ($9.74 in chips) 
Seat 8: OMG EinClown ($2.06 in chips) 
Seat 9: gloommyrat ($9.70 in chips) 
hurla64: posts small blind $0.01
linkk1075: posts big blind $0.02
*** HOLE CARDS ***
Dealt to TrankTank [4d 5d]
irenvik: calls $0.02
pisqnek: raises $0.04 to $0.06
GrafGo999: folds 
5gdangers: folds 
OMG EinClown: folds 
gloommyrat: folds 
TrankTank: folds 
hurla64: folds 
linkk1075: folds 
irenvik: calls $0.04
*** FLOP *** [9c Kh 5s]
irenvik: checks 
pisqnek: checks 
*** TURN *** [9c Kh 5s] [4c]
irenvik: checks 
pisqnek: bets $0.07
irenvik: calls $0.07
*** RIVER *** [9c Kh 5s 4c] [7c]
irenvik: checks 
pisqnek: checks 
*** SHOW DOWN ***
irenvik: shows [8h 8c] (a pair of Eights)
pisqnek: mucks hand 
irenvik collected $0.28 from pot
*** SUMMARY ***
Total pot $0.29 | Rake $0.01 
Board [9c Kh 5s 4c 7c]
Seat 1: TrankTank (button) folded before Flop (didn't bet)
Seat 2: hurla64 (small blind) folded before Flop
Seat 3: linkk1075 (big blind) folded before Flop
Seat 4: irenvik showed [8h 8c] and won ($0.28) with a pair of Eights
Seat 5: pisqnek mucked [Js As]
Seat 6: GrafGo999 folded before Flop (didn't bet)
Seat 7: 5gdangers folded before Flop (didn't bet)
Seat 8: OMG EinClown folded before Flop (didn't bet)
Seat 9: gloommyrat folded before Flop (didn't bet)



PokerStars Zoom Hand #216382918846:  Hold'em No Limit ($0.01/$0.02) - 2020/07/13 19:22:54 CET [2020/07/13 13:22:54 ET]
Table 'McNaught' 9-max Seat #1 is the button
Seat 1: alexburton24 ($3.98 in chips) 
Seat 2: Aveena2 ($2.20 in chips) 
Seat 3: red_81_2009 ($2.08 in chips) 
Seat 4: EliFilho55 ($1.95 in chips) 
Seat 5: OMG EinClown ($2.06 in chips) 
Seat 6: HAL VAGYOK ($2.50 in chips) 
Seat 7: Rummy41 ($2.22 in chips) 
Seat 8: TrankTank ($2 in chips) 
Seat 9: pocoyo088 ($2 in chips) 
Aveena2: posts small blind $0.01
red_81_2009: posts big blind $0.02
*** HOLE CARDS ***
Dealt to TrankTank [8h Qh]
EliFilho55: folds 
OMG EinClown: raises $0.06 to $0.08
HAL VAGYOK: folds 
Rummy41: calls $0.08
TrankTank: folds 
pocoyo088: folds 
alexburton24: folds 
Aveena2: folds 
red_81_2009: folds 
*** FLOP *** [5s 4h 2s]
OMG EinClown: checks 
Rummy41: bets $0.09
OMG EinClown: calls $0.09
*** TURN *** [5s 4h 2s] [4s]
OMG EinClown: checks 
Rummy41: bets $0.22
OMG EinClown: folds 
Uncalled bet ($0.22) returned to Rummy41
Rummy41 collected $0.36 from pot
Rummy41: doesn't show hand 
*** SUMMARY ***
Total pot $0.37 | Rake $0.01 
Board [5s 4h 2s 4s]
Seat 1: alexburton24 (button) folded before Flop (didn't bet)
Seat 2: Aveena2 (small blind) folded before Flop
Seat 3: red_81_2009 (big blind) folded before Flop
Seat 4: EliFilho55 folded before Flop (didn't bet)
Seat 5: OMG EinClown folded on the Turn
Seat 6: HAL VAGYOK folded before Flop (didn't bet)
Seat 7: Rummy41 collected ($0.36)
Seat 8: TrankTank folded before Flop (didn't bet)
Seat 9: pocoyo088 folded before Flop (didn't bet)



PokerStars Zoom Hand #216382935649:  Hold'em No Limit ($0.01/$0.02) - 2020/07/13 19:23:25 CET [2020/07/13 13:23:25 ET]
Table 'McNaught' 9-max Seat #1 is the button
Seat 1: TheBlade8525 ($4.82 in chips) 
Seat 2: jackbam993 ($1.94 in chips) 
Seat 3: wraggy225 ($2.68 in chips) 
Seat 4: niko16321 ($1.07 in chips) 
Seat 5: pisqnek ($1.92 in chips) 
Seat 6: TrankTank ($2 in chips) 
Seat 7: Imipapa49 ($0.90 in chips) 
Seat 8: Elvis ah ha ($2.49 in chips) 
Seat 9: STYNG01 ($15.97 in chips) 
jackbam993: posts small blind $0.01
wraggy225: posts big blind $0.02
*** HOLE CARDS ***
Dealt to TrankTank [7s 2h]
niko16321: folds 
pisqnek: folds 
TrankTank: folds 
Imipapa49: folds 
Elvis ah ha: folds 
STYNG01: folds 
TheBlade8525: raises $0.04 to $0.06
jackbam993: folds 
wraggy225: folds 
Uncalled bet ($0.04) returned to TheBlade8525
TheBlade8525 collected $0.05 from pot
TheBlade8525: doesn't show hand 
*** SUMMARY ***
Total pot $0.05 | Rake $0 
Seat 1: TheBlade8525 (button) collected ($0.05)
Seat 2: jackbam993 (small blind) folded before Flop
Seat 3: wraggy225 (big blind) folded before Flop
Seat 4: niko16321 folded before Flop (didn't bet)
Seat 5: pisqnek folded before Flop (didn't bet)
Seat 6: TrankTank folded before Flop (didn't bet)
Seat 7: Imipapa49 folded before Flop (didn't bet)
Seat 8: Elvis ah ha folded before Flop (didn't bet)
Seat 9: STYNG01 folded before Flop (didn't bet)



PokerStars Zoom Hand #216382940051:  Hold'em No Limit ($0.01/$0.02) - 2020/07/13 19:23:33 CET [2020/07/13 13:23:33 ET]
Table 'McNaught' 9-max Seat #1 is the button
Seat 1: Aveena2 ($2.14 in chips) 
Seat 2: PhilB111 ($2 in chips) 
Seat 3: TrankTank ($2 in chips) 
Seat 4: partizan_vlg ($1.44 in chips) 
Seat 5: sayatsemey ($0.81 in chips) 
Seat 6: Mara6111 ($3.36 in chips) 
Seat 7: pocoyo088 ($2 in chips) 
Seat 8: red_81_2009 ($2.06 in chips) 
Seat 9: sczurek19681 ($4.13 in chips) 
PhilB111: posts small blind $0.01
TrankTank: posts big blind $0.02
*** HOLE CARDS ***
Dealt to TrankTank [7s 8s]
PhilB111 is disconnected 
partizan_vlg: folds 
sayatsemey: raises $0.04 to $0.06
Mara6111: folds 
pocoyo088: folds 
red_81_2009: folds 
sczurek19681: folds 
Aveena2: folds 
PhilB111: folds 
TrankTank: folds 
Uncalled bet ($0.04) returned to sayatsemey
sayatsemey collected $0.05 from pot
*** SUMMARY ***
Total pot $0.05 | Rake $0 
Seat 1: Aveena2 (button) folded before Flop (didn't bet)
Seat 2: PhilB111 (small blind) folded before Flop
Seat 3: TrankTank (big blind) folded before Flop
Seat 4: partizan_vlg folded before Flop (didn't bet)
Seat 5: sayatsemey collected ($0.05)
Seat 6: Mara6111 folded before Flop (didn't bet)
Seat 7: pocoyo088 folded before Flop (didn't bet)
Seat 8: red_81_2009 folded before Flop (didn't bet)
Seat 9: sczurek19681 folded before Flop (didn't bet)



PokerStars Zoom Hand #216382952981:  Hold'em No Limit ($0.01/$0.02) - 2020/07/13 19:23:57 CET [2020/07/13 13:23:57 ET]
Table 'McNaught' 9-max Seat #1 is the button
Seat 1: Brixx440 ($2.22 in chips) 
Seat 2: HAL VAGYOK ($2.78 in chips) 
Seat 3: papatomi4 ($0.81 in chips) 
Seat 4: bogdan_k_ua ($1.36 in chips) 
Seat 5: TrankTank ($2 in chips) 
Seat 6: niko16321 ($1.04 in chips) 
Seat 7: pocoyo088 ($2 in chips) 
Seat 8: avstero ($2.92 in chips) 
Seat 9: partizan_vlg ($1.51 in chips) 
HAL VAGYOK: posts small blind $0.01
papatomi4: posts big blind $0.02
*** HOLE CARDS ***
Dealt to TrankTank [5h 8h]
bogdan_k_ua: folds 
TrankTank: folds 
niko16321: raises $0.02 to $0.04
pocoyo088: folds 
avstero: folds 
partizan_vlg: folds 
Brixx440: folds 
HAL VAGYOK: folds 
papatomi4: raises $0.77 to $0.81 and is all-in
niko16321: folds 
Uncalled bet ($0.77) returned to papatomi4
papatomi4 collected $0.09 from pot
papatomi4: doesn't show hand 
*** SUMMARY ***
Total pot $0.09 | Rake $0 
Seat 1: Brixx440 (button) folded before Flop (didn't bet)
Seat 2: HAL VAGYOK (small blind) folded before Flop
Seat 3: papatomi4 (big blind) collected ($0.09)
Seat 4: bogdan_k_ua folded before Flop (didn't bet)
Seat 5: TrankTank folded before Flop (didn't bet)
Seat 6: niko16321 folded before Flop
Seat 7: pocoyo088 folded before Flop (didn't bet)
Seat 8: avstero folded before Flop (didn't bet)
Seat 9: partizan_vlg folded before Flop (didn't bet)



PokerStars Zoom Hand #216382961591:  Hold'em No Limit ($0.01/$0.02) - 2020/07/13 19:24:13 CET [2020/07/13 13:24:13 ET]
Table 'McNaught' 9-max Seat #1 is the button
Seat 1: alexburton24 ($1.97 in chips) 
Seat 2: TrankTank ($2 in chips) 
Seat 3: snow9001 ($2.27 in chips) 
Seat 4: Fostal_by ($2 in chips) 
Seat 5: avstero ($2.92 in chips) 
Seat 6: PhilB111 ($2 in chips) 
Seat 7: dzhonijs_e ($3.10 in chips) 
Seat 8: cuzmich500 ($2.58 in chips) 
Seat 9: Hyperboreus ($1.92 in chips) 
TrankTank: posts small blind $0.01
snow9001: posts big blind $0.02
*** HOLE CARDS ***
Dealt to TrankTank [As 5s]
PhilB111 is disconnected 
Fostal_by: folds 
avstero: folds 
PhilB111: folds 
dzhonijs_e: folds 
cuzmich500: folds 
Hyperboreus: folds 
alexburton24: folds 
TrankTank: folds 
Uncalled bet ($0.01) returned to snow9001
snow9001 collected $0.02 from pot
snow9001: doesn't show hand 
*** SUMMARY ***
Total pot $0.02 | Rake $0 
Seat 1: alexburton24 (button) folded before Flop (didn't bet)
Seat 2: TrankTank (small blind) folded before Flop
Seat 3: snow9001 (big blind) collected ($0.02)
Seat 4: Fostal_by folded before Flop (didn't bet)
Seat 5: avstero folded before Flop (didn't bet)
Seat 6: PhilB111 folded before Flop (didn't bet)
Seat 7: dzhonijs_e folded before Flop (didn't bet)
Seat 8: cuzmich500 folded before Flop (didn't bet)
Seat 9: Hyperboreus folded before Flop (didn't bet)



PokerStars Zoom Hand #216382973424:  Hold'em No Limit ($0.01/$0.02) - 2020/07/13 19:24:35 CET [2020/07/13 13:24:35 ET]
Table 'McNaught' 9-max Seat #1 is the button
Seat 1: Rummy41 ($2.89 in chips) 
Seat 2: pumpedli ($2 in chips) 
Seat 3: J0SHB0SH ($2 in chips) 
Seat 4: linkk1075 ($7.96 in chips) 
Seat 5: hübispliff ($4.86 in chips) 
Seat 6: sayatsemey ($0.83 in chips) 
Seat 7: Hyperboreus ($1.91 in chips) 
Seat 8: TrankTank ($2 in chips) 
Seat 9: Selckinto ($1.86 in chips) 
pumpedli: posts small blind $0.01
J0SHB0SH: posts big blind $0.02
*** HOLE CARDS ***
Dealt to TrankTank [6h Js]
linkk1075: folds 
hübispliff: folds 
sayatsemey: raises $0.04 to $0.06
Hyperboreus: folds 
TrankTank: folds 
Selckinto: folds 
Rummy41: folds 
pumpedli: folds 
J0SHB0SH: folds 
Uncalled bet ($0.04) returned to sayatsemey
sayatsemey collected $0.05 from pot
sayatsemey: doesn't show hand 
*** SUMMARY ***
Total pot $0.05 | Rake $0 
Seat 1: Rummy41 (button) folded before Flop (didn't bet)
Seat 2: pumpedli (small blind) folded before Flop
Seat 3: J0SHB0SH (big blind) folded before Flop
Seat 4: linkk1075 folded before Flop (didn't bet)
Seat 5: hübispliff folded before Flop (didn't bet)
Seat 6: sayatsemey collected ($0.05)
Seat 7: Hyperboreus folded before Flop (didn't bet)
Seat 8: TrankTank folded before Flop (didn't bet)
Seat 9: Selckinto folded before Flop (didn't bet)



PokerStars Zoom Hand #216382977158:  Hold'em No Limit ($0.01/$0.02) - 2020/07/13 19:24:42 CET [2020/07/13 13:24:42 ET]
Table 'McNaught' 9-max Seat #1 is the button
Seat 1: linkk1075 ($7.96 in chips) 
Seat 2: gloommyrat ($9.60 in chips) 
Seat 3: bruto777 ($1 in chips) 
Seat 4: TrankTank ($2 in chips) 
Seat 5: EliFilho55 ($1.97 in chips) 
Seat 6: skorilo ($1.23 in chips) 
Seat 7: niko16321 ($1 in chips) 
Seat 8: pocoyo088 ($2 in chips) 
Seat 9: pisqnek ($1.82 in chips) 
gloommyrat: posts small blind $0.01
bruto777: posts big blind $0.02
*** HOLE CARDS ***
Dealt to TrankTank [Th Qc]
TrankTank: folds 
EliFilho55: folds 
skorilo: folds 
niko16321: folds 
pocoyo088: folds 
pisqnek: folds 
linkk1075: folds 
gloommyrat: folds 
Uncalled bet ($0.01) returned to bruto777
bruto777 collected $0.02 from pot
bruto777: doesn't show hand 
*** SUMMARY ***
Total pot $0.02 | Rake $0 
Seat 1: linkk1075 (button) folded before Flop (didn't bet)
Seat 2: gloommyrat (small blind) folded before Flop
Seat 3: bruto777 (big blind) collected ($0.02)
Seat 4: TrankTank folded before Flop (didn't bet)
Seat 5: EliFilho55 folded before Flop (didn't bet)
Seat 6: skorilo folded before Flop (didn't bet)
Seat 7: niko16321 folded before Flop (didn't bet)
Seat 8: pocoyo088 folded before Flop (didn't bet)
Seat 9: pisqnek folded before Flop (didn't bet)



PokerStars Zoom Hand #216382980381:  Hold'em No Limit ($0.01/$0.02) - 2020/07/13 19:24:48 CET [2020/07/13 13:24:48 ET]
Table 'McNaught' 9-max Seat #1 is the button
Seat 1: TrankTank ($2 in chips) 
Seat 2: PhilB111 ($2 in chips) 
Seat 3: pisqnek ($1.82 in chips) 
Seat 4: hurla64 ($2.62 in chips) 
Seat 5: Fostal_by ($2.32 in chips) 
Seat 6: pocoyo088 ($2 in chips) 
Seat 7: jackbam993 ($1.93 in chips) 
Seat 8: Dows&Poker ($2.82 in chips) 
Seat 9: cuzmich500 ($2.57 in chips) 
PhilB111: posts small blind $0.01
pisqnek: posts big blind $0.02
*** HOLE CARDS ***
Dealt to TrankTank [3s 7c]
hurla64: folds 
Fostal_by: folds 
pocoyo088: folds 
jackbam993: folds 
Dows&Poker: folds 
cuzmich500: folds 
TrankTank: folds 
PhilB111: raises $0.04 to $0.06
pisqnek: folds 
Uncalled bet ($0.04) returned to PhilB111
PhilB111 collected $0.04 from pot
PhilB111: doesn't show hand 
*** SUMMARY ***
Total pot $0.04 | Rake $0 
Seat 1: TrankTank (button) folded before Flop (didn't bet)
Seat 2: PhilB111 (small blind) collected ($0.04)
Seat 3: pisqnek (big blind) folded before Flop
Seat 4: hurla64 folded before Flop (didn't bet)
Seat 5: Fostal_by folded before Flop (didn't bet)
Seat 6: pocoyo088 folded before Flop (didn't bet)
Seat 7: jackbam993 folded before Flop (didn't bet)
Seat 8: Dows&Poker folded before Flop (didn't bet)
Seat 9: cuzmich500 folded before Flop (didn't bet)



PokerStars Zoom Hand #216382990100:  Hold'em No Limit ($0.01/$0.02) - 2020/07/13 19:25:06 CET [2020/07/13 13:25:06 ET]
Table 'McNaught' 9-max Seat #1 is the button
Seat 1: jackbam993 ($1.93 in chips) 
Seat 2: Artem_l1979 ($1.98 in chips) 
Seat 3: Iron208 ($2.02 in chips) 
Seat 4: ggGoldenPunk ($1.72 in chips) 
Seat 5: J0SHB0SH ($2 in chips) 
Seat 6: GrafGo999 ($1.72 in chips) 
Seat 7: TrankTank ($2 in chips) 
Seat 8: Imipapa49 ($0.56 in chips) 
Seat 9: sfdeep ($0.88 in chips) 
Artem_l1979: posts small blind $0.01
Iron208: posts big blind $0.02
*** HOLE CARDS ***
Dealt to TrankTank [Td 9c]
ggGoldenPunk: folds 
J0SHB0SH: folds 
GrafGo999: folds 
TrankTank: folds 
Imipapa49: folds 
sfdeep: folds 
jackbam993: folds 
Artem_l1979: calls $0.01
Iron208: checks 
*** FLOP *** [8h 3d Ac]
Artem_l1979: checks 
Iron208: checks 
*** TURN *** [8h 3d Ac] [Ts]
Artem_l1979: checks 
Iron208: checks 
*** RIVER *** [8h 3d Ac Ts] [Js]
Artem_l1979: checks 
Iron208: checks 
*** SHOW DOWN ***
Artem_l1979: shows [Kd Qh] (a straight, Ten to Ace)
Iron208: mucks hand 
Artem_l1979 collected $0.04 from pot
*** SUMMARY ***
Total pot $0.04 | Rake $0 
Board [8h 3d Ac Ts Js]
Seat 1: jackbam993 (button) folded before Flop (didn't bet)
Seat 2: Artem_l1979 (small blind) showed [Kd Qh] and won ($0.04) with a straight, Ten to Ace
Seat 3: Iron208 (big blind) mucked [9h 4s]
Seat 4: ggGoldenPunk folded before Flop (didn't bet)
Seat 5: J0SHB0SH folded before Flop (didn't bet)
Seat 6: GrafGo999 folded before Flop (didn't bet)
Seat 7: TrankTank folded before Flop (didn't bet)
Seat 8: Imipapa49 folded before Flop (didn't bet)
Seat 9: sfdeep folded before Flop (didn't bet)



PokerStars Zoom Hand #216382986364:  Hold'em No Limit ($0.01/$0.02) - 2020/07/13 19:24:59 CET [2020/07/13 13:24:59 ET]
Table 'McNaught' 9-max Seat #1 is the button
Seat 1: J0SHB0SH ($2 in chips) 
Seat 2: sfdeep ($0.89 in chips) 
Seat 3: snow9001 ($2.38 in chips) 
Seat 4: gloommyrat ($9.59 in chips) 
Seat 5: qtmm ($2.79 in chips) 
Seat 6: pumpedli ($2.17 in chips) 
Seat 7: STYNG01 ($5.81 in chips) 
Seat 8: RyuInShadow ($2.04 in chips) 
Seat 9: TrankTank ($2 in chips) 
sfdeep: posts small blind $0.01
snow9001: posts big blind $0.02
*** HOLE CARDS ***
Dealt to TrankTank [7s 6d]
gloommyrat: folds 
qtmm: folds 
pumpedli: raises $0.03 to $0.05
STYNG01: calls $0.05
RyuInShadow: folds 
TrankTank: folds 
J0SHB0SH: folds 
sfdeep: folds 
snow9001: calls $0.03
*** FLOP *** [Jh 6h Ad]
snow9001: checks 
pumpedli: checks 
STYNG01: bets $0.10
snow9001: folds 
pumpedli: folds 
Uncalled bet ($0.10) returned to STYNG01
STYNG01 collected $0.15 from pot
STYNG01: doesn't show hand 
*** SUMMARY ***
Total pot $0.16 | Rake $0.01 
Board [Jh 6h Ad]
Seat 1: J0SHB0SH (button) folded before Flop (didn't bet)
Seat 2: sfdeep (small blind) folded before Flop
Seat 3: snow9001 (big blind) folded on the Flop
Seat 4: gloommyrat folded before Flop (didn't bet)
Seat 5: qtmm folded before Flop (didn't bet)
Seat 6: pumpedli folded on the Flop
Seat 7: STYNG01 collected ($0.15)
Seat 8: RyuInShadow folded before Flop (didn't bet)
Seat 9: TrankTank folded before Flop (didn't bet)



PokerStars Zoom Hand #216382998666:  Hold'em No Limit ($0.01/$0.02) - 2020/07/13 19:25:22 CET [2020/07/13 13:25:22 ET]
Table 'McNaught' 9-max Seat #1 is the button
Seat 1: bugsbunnies ($1.87 in chips) 
Seat 2: AndronDJ ($6.69 in chips) 
Seat 3: Aveena2 ($2.07 in chips) 
Seat 4: hurla64 ($6.69 in chips) 
Seat 5: TrankTank ($2 in chips) 
Seat 6: cuzmich500 ($2.57 in chips) 
Seat 7: Krimil ($0.99 in chips) 
Seat 8: HAL VAGYOK ($5.41 in chips) 
Seat 9: gloommyrat ($4.13 in chips) 
AndronDJ: posts small blind $0.01
Aveena2: posts big blind $0.02
*** HOLE CARDS ***
Dealt to TrankTank [7h 2c]
hurla64: folds 
TrankTank: folds 
cuzmich500: raises $0.04 to $0.06
Krimil: calls $0.06
HAL VAGYOK: folds 
gloommyrat: folds 
bugsbunnies: folds 
AndronDJ: folds 
Aveena2: folds 
*** FLOP *** [8h 8c Kd]
cuzmich500: bets $0.10
Krimil: calls $0.10
*** TURN *** [8h 8c Kd] [Jh]
cuzmich500: bets $0.26
Krimil: raises $0.26 to $0.52
cuzmich500: raises $0.96 to $1.48
Krimil: calls $0.31 and is all-in
Uncalled bet ($0.65) returned to cuzmich500
*** RIVER *** [8h 8c Kd Jh] [9c]
*** SHOW DOWN ***
cuzmich500: shows [Kh Ad] (two pair, Kings and Eights)
Krimil: shows [8s As] (three of a kind, Eights)
Krimil collected $1.94 from pot
*** SUMMARY ***
Total pot $2.01 | Rake $0.07 
Board [8h 8c Kd Jh 9c]
Seat 1: bugsbunnies (button) folded before Flop (didn't bet)
Seat 2: AndronDJ (small blind) folded before Flop
Seat 3: Aveena2 (big blind) folded before Flop
Seat 4: hurla64 folded before Flop (didn't bet)
Seat 5: TrankTank folded before Flop (didn't bet)
Seat 6: cuzmich500 showed [Kh Ad] and lost with two pair, Kings and Eights
Seat 7: Krimil showed [8s As] and won ($1.94) with three of a kind, Eights
Seat 8: HAL VAGYOK folded before Flop (didn't bet)
Seat 9: gloommyrat folded before Flop (didn't bet)



PokerStars Zoom Hand #216383002902:  Hold'em No Limit ($0.01/$0.02) - 2020/07/13 19:25:30 CET [2020/07/13 13:25:30 ET]
Table 'McNaught' 9-max Seat #1 is the button
Seat 1: Marmelicious ($1.94 in chips) 
Seat 2: dzhonijs_e ($3.14 in chips) 
Seat 3: cuzmich500 ($2.40 in chips) 
Seat 4: TrankTank ($2 in chips) 
Seat 5: sayatsemey ($2.68 in chips) 
Seat 6: givinfree$ ($2.43 in chips) 
Seat 7: Vulcan615 ($1.21 in chips) 
Seat 8: PhilB111 ($3.88 in chips) 
Seat 9: Selckinto ($2.59 in chips) 
dzhonijs_e: posts small blind $0.01
cuzmich500: posts big blind $0.02
*** HOLE CARDS ***
Dealt to TrankTank [Ks Qs]
TrankTank: raises $0.04 to $0.06
sayatsemey: folds 
givinfree$: folds 
Vulcan615: folds 
PhilB111: calls $0.06
Selckinto: folds 
Marmelicious: folds 
dzhonijs_e: folds 
cuzmich500: folds 
*** FLOP *** [Jd Ah 4c]
TrankTank: bets $0.10
PhilB111: calls $0.10
*** TURN *** [Jd Ah 4c] [7c]
TrankTank: checks 
PhilB111: checks 
*** RIVER *** [Jd Ah 4c 7c] [Kd]
TrankTank: checks 
PhilB111: bets $0.76
TrankTank: folds 
Uncalled bet ($0.76) returned to PhilB111
PhilB111 collected $0.34 from pot
PhilB111: doesn't show hand 
*** SUMMARY ***
Total pot $0.35 | Rake $0.01 
Board [Jd Ah 4c 7c Kd]
Seat 1: Marmelicious (button) folded before Flop (didn't bet)
Seat 2: dzhonijs_e (small blind) folded before Flop
Seat 3: cuzmich500 (big blind) folded before Flop
Seat 4: TrankTank folded on the River
Seat 5: sayatsemey folded before Flop (didn't bet)
Seat 6: givinfree$ folded before Flop (didn't bet)
Seat 7: Vulcan615 folded before Flop (didn't bet)
Seat 8: PhilB111 collected ($0.34)
Seat 9: Selckinto folded before Flop (didn't bet)



PokerStars Zoom Hand #216383041455:  Hold'em No Limit ($0.01/$0.02) - 2020/07/13 19:26:41 CET [2020/07/13 13:26:41 ET]
Table 'McNaught' 9-max Seat #1 is the button
Seat 1: hübispliff ($7.08 in chips) 
Seat 2: hurla64 ($5.02 in chips) 
Seat 3: joehlavicka ($2 in chips) 
Seat 4: givinfree$ ($4.30 in chips) 
Seat 5: birarema ($1.97 in chips) 
Seat 6: TrankTank ($2 in chips) 
Seat 7: PhilB111 ($2 in chips) 
Seat 8: GrafGo999 ($3.41 in chips) 
Seat 9: Scorpi0n777 ($2.36 in chips) 
hurla64: posts small blind $0.01
joehlavicka: posts big blind $0.02
*** HOLE CARDS ***
Dealt to TrankTank [8d 9c]
givinfree$: folds 
birarema: folds 
TrankTank: folds 
PhilB111: raises $0.04 to $0.06
GrafGo999: folds 
Scorpi0n777: folds 
hübispliff has timed out
hübispliff: folds 
hurla64: folds 
joehlavicka: folds 
Uncalled bet ($0.04) returned to PhilB111
PhilB111 collected $0.05 from pot
PhilB111: doesn't show hand 
*** SUMMARY ***
Total pot $0.05 | Rake $0 
Seat 1: hübispliff (button) folded before Flop (didn't bet)
Seat 2: hurla64 (small blind) folded before Flop
Seat 3: joehlavicka (big blind) folded before Flop
Seat 4: givinfree$ folded before Flop (didn't bet)
Seat 5: birarema folded before Flop (didn't bet)
Seat 6: TrankTank folded before Flop (didn't bet)
Seat 7: PhilB111 collected ($0.05)
Seat 8: GrafGo999 folded before Flop (didn't bet)
Seat 9: Scorpi0n777 folded before Flop (didn't bet)



PokerStars Zoom Hand #216383057746:  Hold'em No Limit ($0.01/$0.02) - 2020/07/13 19:26:58 CET [2020/07/13 13:26:58 ET]
Table 'McNaught' 9-max Seat #1 is the button
Seat 1: alosksora ($2.01 in chips) 
Seat 2: STYNG01 ($17.10 in chips) 
Seat 3: TrankTank ($2 in chips) 
Seat 4: hurla64 ($4.93 in chips) 
Seat 5: Marious92992 ($2.03 in chips) 
Seat 6: wraggy225 ($1.57 in chips) 
Seat 7: Elvis ah ha ($2.41 in chips) 
Seat 8: AndronDJ ($6.68 in chips) 
Seat 9: Iron208 ($2 in chips) 
STYNG01: posts small blind $0.01
TrankTank: posts big blind $0.02
*** HOLE CARDS ***
Dealt to TrankTank [3s Jc]
hurla64: folds 
Marious92992: folds 
wraggy225: raises $0.05 to $0.07
Elvis ah ha: calls $0.07
AndronDJ: folds 
Iron208: folds 
alosksora: folds 
STYNG01: folds 
TrankTank: folds 
*** FLOP *** [Tc 9s 2h]
wraggy225: bets $0.10
Elvis ah ha: folds 
Uncalled bet ($0.10) returned to wraggy225
wraggy225 collected $0.16 from pot
wraggy225: doesn't show hand 
*** SUMMARY ***
Total pot $0.17 | Rake $0.01 
Board [Tc 9s 2h]
Seat 1: alosksora (button) folded before Flop (didn't bet)
Seat 2: STYNG01 (small blind) folded before Flop
Seat 3: TrankTank (big blind) folded before Flop
Seat 4: hurla64 folded before Flop (didn't bet)
Seat 5: Marious92992 folded before Flop (didn't bet)
Seat 6: wraggy225 collected ($0.16)
Seat 7: Elvis ah ha folded on the Flop
Seat 8: AndronDJ folded before Flop (didn't bet)
Seat 9: Iron208 folded before Flop (didn't bet)



PokerStars Zoom Hand #216383076663:  Hold'em No Limit ($0.01/$0.02) - 2020/07/13 19:27:33 CET [2020/07/13 13:27:33 ET]
Table 'McNaught' 9-max Seat #1 is the button
Seat 1: mg-deniz ($6.15 in chips) 
Seat 2: GaliRah ($2.42 in chips) 
Seat 3: AndronDJ ($4.43 in chips) 
Seat 4: PhilB111 ($2.03 in chips) 
Seat 5: alexburton24 ($2.01 in chips) 
Seat 6: Fostal_by ($2 in chips) 
Seat 7: Aveena2 ($2 in chips) 
Seat 8: oanhoanh ($2 in chips) 
Seat 9: TrankTank ($2 in chips) 
GaliRah: posts small blind $0.01
AndronDJ: posts big blind $0.02
*** HOLE CARDS ***
Dealt to TrankTank [2h 8h]
PhilB111: raises $0.04 to $0.06
alexburton24: folds 
Fostal_by: folds 
Aveena2: folds 
oanhoanh: folds 
TrankTank: folds 
mg-deniz: folds 
GaliRah: folds 
AndronDJ: folds 
Uncalled bet ($0.04) returned to PhilB111
PhilB111 collected $0.05 from pot
PhilB111: doesn't show hand 
*** SUMMARY ***
Total pot $0.05 | Rake $0 
Seat 1: mg-deniz (button) folded before Flop (didn't bet)
Seat 2: GaliRah (small blind) folded before Flop
Seat 3: AndronDJ (big blind) folded before Flop
Seat 4: PhilB111 collected ($0.05)
Seat 5: alexburton24 folded before Flop (didn't bet)
Seat 6: Fostal_by folded before Flop (didn't bet)
Seat 7: Aveena2 folded before Flop (didn't bet)
Seat 8: oanhoanh folded before Flop (didn't bet)
Seat 9: TrankTank folded before Flop (didn't bet)



PokerStars Zoom Hand #216383068522:  Hold'em No Limit ($0.01/$0.02) - 2020/07/13 19:27:18 CET [2020/07/13 13:27:18 ET]
Table 'McNaught' 9-max Seat #1 is the button
Seat 1: PhilB111 ($2.56 in chips) 
Seat 2: Rummy41 ($2.85 in chips) 
Seat 3: sayatsemey ($0.81 in chips) 
Seat 4: dmitrychuk ($4.92 in chips) 
Seat 5: givinfree$ ($3.44 in chips) 
Seat 6: GaliRah ($2.42 in chips) 
Seat 7: TrankTank ($2 in chips) 
Seat 8: Mara6111 ($3.30 in chips) 
Seat 9: papatomi4 ($1.94 in chips) 
Rummy41: posts small blind $0.01
sayatsemey: posts big blind $0.02
*** HOLE CARDS ***
Dealt to TrankTank [4s Qs]
dmitrychuk: raises $0.02 to $0.04
givinfree$: folds 
GaliRah: folds 
PhilB111 is disconnected 
TrankTank: folds 
Mara6111: folds 
papatomi4: calls $0.04
PhilB111: folds 
Rummy41: folds 
sayatsemey: calls $0.02
*** FLOP *** [Th Ac 3h]
sayatsemey: bets $0.07
dmitrychuk: calls $0.07
papatomi4: folds 
*** TURN *** [Th Ac 3h] [Td]
sayatsemey: bets $0.13
dmitrychuk: folds 
Uncalled bet ($0.13) returned to sayatsemey
sayatsemey collected $0.26 from pot
sayatsemey: doesn't show hand 
*** SUMMARY ***
Total pot $0.27 | Rake $0.01 
Board [Th Ac 3h Td]
Seat 1: PhilB111 (button) folded before Flop (didn't bet)
Seat 2: Rummy41 (small blind) folded before Flop
Seat 3: sayatsemey (big blind) collected ($0.26)
Seat 4: dmitrychuk folded on the Turn
Seat 5: givinfree$ folded before Flop (didn't bet)
Seat 6: GaliRah folded before Flop (didn't bet)
Seat 7: TrankTank folded before Flop (didn't bet)
Seat 8: Mara6111 folded before Flop (didn't bet)
Seat 9: papatomi4 folded on the Flop



PokerStars Zoom Hand #216383086852:  Hold'em No Limit ($0.01/$0.02) - 2020/07/13 19:27:52 CET [2020/07/13 13:27:52 ET]
Table 'McNaught' 9-max Seat #1 is the button
Seat 1: TrankTank ($2 in chips) 
Seat 2: Marmelicious ($1.91 in chips) 
Seat 3: Aveena2 ($2 in chips) 
Seat 4: gloommyrat ($3.11 in chips) 
Seat 5: cuzmich500 ($1.55 in chips) 
Seat 6: PhilB111 ($2.06 in chips) 
Seat 7: Brixx440 ($2.63 in chips) 
Seat 8: mg-deniz ($3.56 in chips) 
Seat 9: wraggy225 ($1.66 in chips) 
Marmelicious: posts small blind $0.01
Aveena2: posts big blind $0.02
*** HOLE CARDS ***
Dealt to TrankTank [As Kc]
gloommyrat: folds 
cuzmich500: folds 
PhilB111: folds 
Brixx440: folds 
PhilB111 is disconnected 
mg-deniz: folds 
wraggy225: folds 
TrankTank: raises $0.04 to $0.06
Marmelicious: folds 
Aveena2: folds 
Uncalled bet ($0.04) returned to TrankTank
TrankTank collected $0.05 from pot
TrankTank: doesn't show hand 
*** SUMMARY ***
Total pot $0.05 | Rake $0 
Seat 1: TrankTank (button) collected ($0.05)
Seat 2: Marmelicious (small blind) folded before Flop
Seat 3: Aveena2 (big blind) folded before Flop
Seat 4: gloommyrat folded before Flop (didn't bet)
Seat 5: cuzmich500 folded before Flop (didn't bet)
Seat 6: PhilB111 folded before Flop (didn't bet)
Seat 7: Brixx440 folded before Flop (didn't bet)
Seat 8: mg-deniz folded before Flop (didn't bet)
Seat 9: wraggy225 folded before Flop (didn't bet)



PokerStars Zoom Hand #216383080426:  Hold'em No Limit ($0.01/$0.02) - 2020/07/13 19:27:40 CET [2020/07/13 13:27:40 ET]
Table 'McNaught' 9-max Seat #1 is the button
Seat 1: red_81_2009 ($1.54 in chips) 
Seat 2: TrankTank ($2 in chips) 
Seat 3: hurla64 ($2.09 in chips) 
Seat 4: wraggy225 ($1.66 in chips) 
Seat 5: KillyLo ($0.65 in chips) 
Seat 6: BONECA DELICADA ($1.82 in chips) 
Seat 7: partizan_vlg ($1.45 in chips) 
Seat 8: pumpedli ($2.50 in chips) 
Seat 9: Mara6111 ($3.30 in chips) 
TrankTank: posts small blind $0.01
hurla64: posts big blind $0.02
*** HOLE CARDS ***
Dealt to TrankTank [7s 9c]
wraggy225: folds 
KillyLo: folds 
BONECA DELICADA: folds 
partizan_vlg: folds 
pumpedli: folds 
Mara6111: folds 
red_81_2009: raises $0.02 to $0.04
TrankTank: folds 
hurla64: calls $0.02
*** FLOP *** [Qh 3h Qs]
hurla64: checks 
red_81_2009: bets $0.05
hurla64: folds 
Uncalled bet ($0.05) returned to red_81_2009
red_81_2009 collected $0.09 from pot
red_81_2009: doesn't show hand 
*** SUMMARY ***
Total pot $0.09 | Rake $0 
Board [Qh 3h Qs]
Seat 1: red_81_2009 (button) collected ($0.09)
Seat 2: TrankTank (small blind) folded before Flop
Seat 3: hurla64 (big blind) folded on the Flop
Seat 4: wraggy225 folded before Flop (didn't bet)
Seat 5: KillyLo folded before Flop (didn't bet)
Seat 6: BONECA DELICADA folded before Flop (didn't bet)
Seat 7: partizan_vlg folded before Flop (didn't bet)
Seat 8: pumpedli folded before Flop (didn't bet)
Seat 9: Mara6111 folded before Flop (didn't bet)



PokerStars Zoom Hand #216383096602:  Hold'em No Limit ($0.01/$0.02) - 2020/07/13 19:28:10 CET [2020/07/13 13:28:10 ET]
Table 'McNaught' 9-max Seat #1 is the button
Seat 1: PhilB111 ($4.03 in chips) 
Seat 2: sayatsemey ($0.96 in chips) 
Seat 3: linkk1075 ($8.07 in chips) 
Seat 4: hoss145 ($2.08 in chips) 
Seat 5: Imipapa49 ($0.55 in chips) 
Seat 6: hurla64 ($11.01 in chips) 
Seat 7: mg-deniz ($3.55 in chips) 
Seat 8: TrankTank ($2.03 in chips) 
Seat 9: red_81_2009 ($1.59 in chips) 
sayatsemey: posts small blind $0.01
linkk1075: posts big blind $0.02
*** HOLE CARDS ***
Dealt to TrankTank [3d Jc]
hoss145: folds 
Imipapa49: raises $0.53 to $0.55 and is all-in
hurla64: folds 
mg-deniz: folds 
PhilB111 is disconnected 
TrankTank: folds 
red_81_2009: folds 
PhilB111: folds 
sayatsemey: raises $0.41 to $0.96 and is all-in
linkk1075: folds 
Uncalled bet ($0.41) returned to sayatsemey
*** FLOP *** [2d 3h 4s]
*** TURN *** [2d 3h 4s] [9c]
*** RIVER *** [2d 3h 4s 9c] [Qs]
*** SHOW DOWN ***
sayatsemey: shows [8c 8d] (a pair of Eights)
Imipapa49: shows [Kc Td] (high card King)
sayatsemey collected $1.08 from pot
*** SUMMARY ***
Total pot $1.12 | Rake $0.04 
Board [2d 3h 4s 9c Qs]
Seat 1: PhilB111 (button) folded before Flop (didn't bet)
Seat 2: sayatsemey (small blind) showed [8c 8d] and won ($1.08) with a pair of Eights
Seat 3: linkk1075 (big blind) folded before Flop
Seat 4: hoss145 folded before Flop (didn't bet)
Seat 5: Imipapa49 showed [Kc Td] and lost with high card King
Seat 6: hurla64 folded before Flop (didn't bet)
Seat 7: mg-deniz folded before Flop (didn't bet)
Seat 8: TrankTank folded before Flop (didn't bet)
Seat 9: red_81_2009 folded before Flop (didn't bet)



PokerStars Zoom Hand #216383103743:  Hold'em No Limit ($0.01/$0.02) - 2020/07/13 19:28:23 CET [2020/07/13 13:28:23 ET]
Table 'McNaught' 9-max Seat #1 is the button
Seat 1: niko16321 ($0.96 in chips) 
Seat 2: pumpedli ($2.50 in chips) 
Seat 3: alosksora ($2.12 in chips) 
Seat 4: TrankTank ($2.03 in chips) 
Seat 5: kennetcook ($1.30 in chips) 
Seat 6: AndronDJ ($4.40 in chips) 
Seat 7: Selckinto ($2.59 in chips) 
Seat 8: red_81_2009 ($1.59 in chips) 
Seat 9: givinfree$ ($2.38 in chips) 
pumpedli: posts small blind $0.01
alosksora: posts big blind $0.02
*** HOLE CARDS ***
Dealt to TrankTank [Ad Kh]
TrankTank: raises $0.04 to $0.06
kennetcook: calls $0.06
AndronDJ: folds 
Selckinto: folds 
red_81_2009: folds 
givinfree$: folds 
niko16321: folds 
pumpedli: folds 
alosksora: calls $0.04
*** FLOP *** [Qh 5h Jd]
alosksora: bets $0.12
TrankTank: folds 
kennetcook: folds 
Uncalled bet ($0.12) returned to alosksora
alosksora collected $0.18 from pot
alosksora: doesn't show hand 
kennetcook is disconnected 
*** SUMMARY ***
Total pot $0.19 | Rake $0.01 
Board [Qh 5h Jd]
Seat 1: niko16321 (button) folded before Flop (didn't bet)
Seat 2: pumpedli (small blind) folded before Flop
Seat 3: alosksora (big blind) collected ($0.18)
Seat 4: TrankTank folded on the Flop
Seat 5: kennetcook folded on the Flop
Seat 6: AndronDJ folded before Flop (didn't bet)
Seat 7: Selckinto folded before Flop (didn't bet)
Seat 8: red_81_2009 folded before Flop (didn't bet)
Seat 9: givinfree$ folded before Flop (didn't bet)



PokerStars Zoom Hand #216383126882:  Hold'em No Limit ($0.01/$0.02) - 2020/07/13 19:29:06 CET [2020/07/13 13:29:06 ET]
Table 'McNaught' 9-max Seat #1 is the button
Seat 1: wraggy225 ($2.71 in chips) 
Seat 2: red_81_2009 ($3.77 in chips) 
Seat 3: Selckinto ($2.35 in chips) 
Seat 4: TrankTank ($2 in chips) 
Seat 5: snow9001 ($2 in chips) 
Seat 6: AniArun ($1.23 in chips) 
Seat 7: Dows&Poker ($1.97 in chips) 
Seat 8: Climax82 ($1.27 in chips) 
Seat 9: Aveena2 ($2.01 in chips) 
red_81_2009: posts small blind $0.01
Selckinto: posts big blind $0.02
*** HOLE CARDS ***
Dealt to TrankTank [2s 7c]
TrankTank: folds 
snow9001: folds 
AniArun: folds 
Dows&Poker: folds 
Climax82: calls $0.02
Aveena2: folds 
wraggy225: folds 
red_81_2009: calls $0.01
Selckinto: checks 
*** FLOP *** [9c 6d Th]
red_81_2009: checks 
Selckinto: checks 
Climax82: bets $0.03
red_81_2009: folds 
Selckinto: calls $0.03
*** TURN *** [9c 6d Th] [Tc]
Selckinto: checks 
Climax82: bets $0.06
Selckinto: calls $0.06
*** RIVER *** [9c 6d Th Tc] [5s]
Selckinto: checks 
Climax82: checks 
*** SHOW DOWN ***
Selckinto: shows [9d 3h] (two pair, Tens and Nines)
Climax82: shows [8d 9h] (two pair, Tens and Nines - Eight kicker)
Climax82 collected $0.23 from pot
*** SUMMARY ***
Total pot $0.24 | Rake $0.01 
Board [9c 6d Th Tc 5s]
Seat 1: wraggy225 (button) folded before Flop (didn't bet)
Seat 2: red_81_2009 (small blind) folded on the Flop
Seat 3: Selckinto (big blind) showed [9d 3h] and lost with two pair, Tens and Nines
Seat 4: TrankTank folded before Flop (didn't bet)
Seat 5: snow9001 folded before Flop (didn't bet)
Seat 6: AniArun folded before Flop (didn't bet)
Seat 7: Dows&Poker folded before Flop (didn't bet)
Seat 8: Climax82 showed [8d 9h] and won ($0.23) with two pair, Tens and Nines
Seat 9: Aveena2 folded before Flop (didn't bet)



PokerStars Zoom Hand #216383143491:  Hold'em No Limit ($0.01/$0.02) - 2020/07/13 19:29:37 CET [2020/07/13 13:29:37 ET]
Table 'McNaught' 9-max Seat #1 is the button
Seat 1: snow9001 ($2 in chips) 
Seat 2: TrankTank ($2 in chips) 
Seat 3: Dows&Poker ($1.97 in chips) 
Seat 4: alexburton24 ($1.94 in chips) 
Seat 5: oanhoanh ($2.56 in chips) 
Seat 6: Elvis ah ha ($2.28 in chips) 
Seat 7: BONECA DELICADA ($1.77 in chips) 
Seat 8: XHerrTUMNUSX ($4.51 in chips) 
Seat 9: AndreiSlaShh ($2 in chips) 
TrankTank: posts small blind $0.01
Dows&Poker: posts big blind $0.02
*** HOLE CARDS ***
Dealt to TrankTank [8c 9d]
alexburton24: folds 
oanhoanh: folds 
Elvis ah ha: folds 
BONECA DELICADA: folds 
XHerrTUMNUSX: folds 
AndreiSlaShh: folds 
snow9001: folds 
TrankTank: folds 
Uncalled bet ($0.01) returned to Dows&Poker
Dows&Poker collected $0.02 from pot
Dows&Poker: doesn't show hand 
*** SUMMARY ***
Total pot $0.02 | Rake $0 
Seat 1: snow9001 (button) folded before Flop (didn't bet)
Seat 2: TrankTank (small blind) folded before Flop
Seat 3: Dows&Poker (big blind) collected ($0.02)
Seat 4: alexburton24 folded before Flop (didn't bet)
Seat 5: oanhoanh folded before Flop (didn't bet)
Seat 6: Elvis ah ha folded before Flop (didn't bet)
Seat 7: BONECA DELICADA folded before Flop (didn't bet)
Seat 8: XHerrTUMNUSX folded before Flop (didn't bet)
Seat 9: AndreiSlaShh folded before Flop (didn't bet)



PokerStars Zoom Hand #216383119385:  Hold'em No Limit ($0.01/$0.02) - 2020/07/13 19:28:52 CET [2020/07/13 13:28:52 ET]
Table 'McNaught' 9-max Seat #1 is the button
Seat 1: alexburton24 ($1.95 in chips) 
Seat 2: Marmelicious ($1.88 in chips) 
Seat 3: BONECA DELICADA ($1.90 in chips) 
Seat 4: AndronDJ ($4.40 in chips) 
Seat 5: TrankTank ($2 in chips) 
Seat 6: dmitrychuk ($5.01 in chips) 
Seat 7: cathousecat ($3.82 in chips) 
Seat 8: RSM820 ($0.80 in chips) 
Seat 9: irenvik ($1.30 in chips) 
Marmelicious: posts small blind $0.01
BONECA DELICADA: posts big blind $0.02
*** HOLE CARDS ***
Dealt to TrankTank [7c 8c]
AndronDJ: raises $0.04 to $0.06
TrankTank: folds 
dmitrychuk: calls $0.06
cathousecat: calls $0.06
RSM820: calls $0.06
irenvik: folds 
alexburton24: folds 
Marmelicious: folds 
BONECA DELICADA: folds 
*** FLOP *** [Kd 4c 9c]
AndronDJ: checks 
dmitrychuk: checks 
cathousecat: bets $0.06
RSM820: calls $0.06
AndronDJ: calls $0.06
dmitrychuk: folds 
*** TURN *** [Kd 4c 9c] [5d]
AndronDJ: checks 
cathousecat: bets $0.15
RSM820: calls $0.15
AndronDJ: calls $0.15
*** RIVER *** [Kd 4c 9c 5d] [Js]
AndronDJ: checks 
cathousecat: bets $0.20
RSM820: calls $0.20
AndronDJ: folds 
*** SHOW DOWN ***
cathousecat: shows [9d 9s] (three of a kind, Nines)
RSM820: mucks hand 
cathousecat collected $1.25 from pot
*** SUMMARY ***
Total pot $1.30 | Rake $0.05 
Board [Kd 4c 9c 5d Js]
Seat 1: alexburton24 (button) folded before Flop (didn't bet)
Seat 2: Marmelicious (small blind) folded before Flop
Seat 3: BONECA DELICADA (big blind) folded before Flop
Seat 4: AndronDJ folded on the River
Seat 5: TrankTank folded before Flop (didn't bet)
Seat 6: dmitrychuk folded on the Flop
Seat 7: cathousecat showed [9d 9s] and won ($1.25) with three of a kind, Nines
Seat 8: RSM820 mucked [Kh Qh]
Seat 9: irenvik folded before Flop (didn't bet)



PokerStars Zoom Hand #216383153133:  Hold'em No Limit ($0.01/$0.02) - 2020/07/13 19:29:55 CET [2020/07/13 13:29:55 ET]
Table 'McNaught' 9-max Seat #1 is the button
Seat 1: Fostal_by ($2.72 in chips) 
Seat 2: givinfree$ ($4.24 in chips) 
Seat 3: AndreiSlaShh ($2 in chips) 
Seat 4: sayatsemey ($1.98 in chips) 
Seat 5: ZOLOTOW ($1.07 in chips) 
Seat 6: Iron208 ($2 in chips) 
Seat 7: gloommyrat ($2.97 in chips) 
Seat 8: TrankTank ($2 in chips) 
Seat 9: alexburton24 ($5.25 in chips) 
givinfree$: posts small blind $0.01
AndreiSlaShh: posts big blind $0.02
*** HOLE CARDS ***
Dealt to TrankTank [5h Qs]
sayatsemey: folds 
ZOLOTOW: calls $0.02
Iron208: folds 
gloommyrat: folds 
TrankTank: folds 
alexburton24: folds 
Fostal_by: calls $0.02
givinfree$: folds 
AndreiSlaShh: checks 
*** FLOP *** [Kd Jh Ts]
AndreiSlaShh: checks 
ZOLOTOW: bets $0.02
Fostal_by: folds 
AndreiSlaShh: calls $0.02
*** TURN *** [Kd Jh Ts] [9d]
AndreiSlaShh: checks 
ZOLOTOW: bets $0.06
AndreiSlaShh: folds 
Uncalled bet ($0.06) returned to ZOLOTOW
ZOLOTOW collected $0.11 from pot
ZOLOTOW: doesn't show hand 
*** SUMMARY ***
Total pot $0.11 | Rake $0 
Board [Kd Jh Ts 9d]
Seat 1: Fostal_by (button) folded on the Flop
Seat 2: givinfree$ (small blind) folded before Flop
Seat 3: AndreiSlaShh (big blind) folded on the Turn
Seat 4: sayatsemey folded before Flop (didn't bet)
Seat 5: ZOLOTOW collected ($0.11)
Seat 6: Iron208 folded before Flop (didn't bet)
Seat 7: gloommyrat folded before Flop (didn't bet)
Seat 8: TrankTank folded before Flop (didn't bet)
Seat 9: alexburton24 folded before Flop (didn't bet)



PokerStars Zoom Hand #216383165222:  Hold'em No Limit ($0.01/$0.02) - 2020/07/13 19:30:17 CET [2020/07/13 13:30:17 ET]
Table 'McNaught' 9-max Seat #1 is the button
Seat 1: STYNG01 ($4.14 in chips) 
Seat 2: papatomi4 ($2.23 in chips) 
Seat 3: givinfree$ ($3.34 in chips) 
Seat 4: AndronDJ ($6.93 in chips) 
Seat 5: RSM820 ($0.33 in chips) 
Seat 6: Marmelicious ($1.84 in chips) 
Seat 7: Dows&Poker ($1.65 in chips) 
Seat 8: Sheriffkotik ($0.97 in chips) 
Seat 9: TrankTank ($2 in chips) 
papatomi4: posts small blind $0.01
givinfree$: posts big blind $0.02
*** HOLE CARDS ***
Dealt to TrankTank [Qh 5c]
AndronDJ: folds 
RSM820: folds 
Marmelicious: folds 
Dows&Poker: folds 
Sheriffkotik: folds 
TrankTank: folds 
STYNG01: folds 
papatomi4: folds 
Uncalled bet ($0.01) returned to givinfree$
givinfree$ collected $0.02 from pot
givinfree$: doesn't show hand 
*** SUMMARY ***
Total pot $0.02 | Rake $0 
Seat 1: STYNG01 (button) folded before Flop (didn't bet)
Seat 2: papatomi4 (small blind) folded before Flop
Seat 3: givinfree$ (big blind) collected ($0.02)
Seat 4: AndronDJ folded before Flop (didn't bet)
Seat 5: RSM820 folded before Flop (didn't bet)
Seat 6: Marmelicious folded before Flop (didn't bet)
Seat 7: Dows&Poker folded before Flop (didn't bet)
Seat 8: Sheriffkotik folded before Flop (didn't bet)
Seat 9: TrankTank folded before Flop (didn't bet)



PokerStars Zoom Hand #216383129477:  Hold'em No Limit ($0.01/$0.02) - 2020/07/13 19:29:11 CET [2020/07/13 13:29:11 ET]
Table 'McNaught' 9-max Seat #1 is the button
Seat 1: alexburton24 ($5.31 in chips) 
Seat 2: kennetcook ($1.22 in chips) 
Seat 3: TrankTank ($2 in chips) 
Seat 4: skorilo ($0.92 in chips) 
Seat 5: Marmelicious ($1.87 in chips) 
Seat 6: Kepas1 ($3.21 in chips) 
Seat 7: Iron208 ($2 in chips) 
Seat 8: bugsbunnies ($2.32 in chips) 
Seat 9: pumpedli ($2.63 in chips) 
kennetcook: posts small blind $0.01
TrankTank: posts big blind $0.02
*** HOLE CARDS ***
Dealt to TrankTank [8s Ts]
skorilo: calls $0.02
Marmelicious: folds 
Kepas1: calls $0.02
Iron208: folds 
bugsbunnies: raises $0.12 to $0.14
pumpedli: folds 
alexburton24: folds 
kennetcook: folds 
kennetcook is disconnected 
TrankTank: folds 
skorilo: folds 
Kepas1: calls $0.12
*** FLOP *** [9c 3h 7h]
Kepas1: checks 
bugsbunnies: bets $0.20
Kepas1: calls $0.20
*** TURN *** [9c 3h 7h] [8c]
Kepas1: checks 
bugsbunnies: bets $0.35
Kepas1: calls $0.35
*** RIVER *** [9c 3h 7h 8c] [Jd]
Kepas1: bets $0.69
bugsbunnies: folds 
Uncalled bet ($0.69) returned to Kepas1
Kepas1 collected $1.38 from pot
Kepas1: doesn't show hand 
*** SUMMARY ***
Total pot $1.43 | Rake $0.05 
Board [9c 3h 7h 8c Jd]
Seat 1: alexburton24 (button) folded before Flop (didn't bet)
Seat 2: kennetcook (small blind) folded before Flop
Seat 3: TrankTank (big blind) folded before Flop
Seat 4: skorilo folded before Flop
Seat 5: Marmelicious folded before Flop (didn't bet)
Seat 6: Kepas1 collected ($1.38)
Seat 7: Iron208 folded before Flop (didn't bet)
Seat 8: bugsbunnies folded on the River
Seat 9: pumpedli folded before Flop (didn't bet)



PokerStars Zoom Hand #216383181905:  Hold'em No Limit ($0.01/$0.02) - 2020/07/13 19:30:48 CET [2020/07/13 13:30:48 ET]
Table 'McNaught' 9-max Seat #1 is the button
Seat 1: Dows&Poker ($1.65 in chips) 
Seat 2: xAndrzej-K ($6.52 in chips) 
Seat 3: Pentonomix ($1 in chips) 
Seat 4: snow9001 ($2 in chips) 
Seat 5: EliFilho55 ($0.43 in chips) 
Seat 6: Selckinto ($2.62 in chips) 
Seat 7: TrankTank ($2 in chips) 
Seat 8: red_81_2009 ($1.62 in chips) 
Seat 9: TheBlade8525 ($4.69 in chips) 
xAndrzej-K: posts small blind $0.01
Pentonomix: posts big blind $0.02
*** HOLE CARDS ***
Dealt to TrankTank [Qd 7s]
snow9001: folds 
EliFilho55: folds 
Selckinto: folds 
TrankTank: folds 
red_81_2009: folds 
TheBlade8525: folds 
Dows&Poker: raises $0.04 to $0.06
xAndrzej-K: folds 
Pentonomix: folds 
Uncalled bet ($0.04) returned to Dows&Poker
Dows&Poker collected $0.05 from pot
Dows&Poker: doesn't show hand 
*** SUMMARY ***
Total pot $0.05 | Rake $0 
Seat 1: Dows&Poker (button) collected ($0.05)
Seat 2: xAndrzej-K (small blind) folded before Flop
Seat 3: Pentonomix (big blind) folded before Flop
Seat 4: snow9001 folded before Flop (didn't bet)
Seat 5: EliFilho55 folded before Flop (didn't bet)
Seat 6: Selckinto folded before Flop (didn't bet)
Seat 7: TrankTank folded before Flop (didn't bet)
Seat 8: red_81_2009 folded before Flop (didn't bet)
Seat 9: TheBlade8525 folded before Flop (didn't bet)



PokerStars Zoom Hand #216383173815:  Hold'em No Limit ($0.01/$0.02) - 2020/07/13 19:30:33 CET [2020/07/13 13:30:33 ET]
Table 'McNaught' 9-max Seat #1 is the button
Seat 1: TrankTank ($2 in chips) 
Seat 2: pocoyo088 ($3.82 in chips) 
Seat 3: Rummy41 ($2.65 in chips) 
Seat 4: gloommyrat ($9.67 in chips) 
Seat 5: Mara6111 ($3.16 in chips) 
Seat 6: BadBeat Bert ($2.89 in chips) 
Seat 7: PhilB111 ($4.03 in chips) 
Seat 8: ggGoldenPunk ($1.74 in chips) 
Seat 9: pumpedli ($2.45 in chips) 
pocoyo088: posts small blind $0.01
Rummy41: posts big blind $0.02
*** HOLE CARDS ***
Dealt to TrankTank [3c Kh]
gloommyrat: folds 
Mara6111: folds 
PhilB111 is disconnected 
BadBeat Bert: folds 
PhilB111: folds 
ggGoldenPunk: calls $0.02
pumpedli: raises $0.04 to $0.06
TrankTank: folds 
pocoyo088: raises $0.16 to $0.22
Rummy41: folds 
ggGoldenPunk: folds 
pumpedli: folds 
Uncalled bet ($0.16) returned to pocoyo088
pocoyo088 collected $0.16 from pot
pocoyo088: doesn't show hand 
*** SUMMARY ***
Total pot $0.16 | Rake $0 
Seat 1: TrankTank (button) folded before Flop (didn't bet)
Seat 2: pocoyo088 (small blind) collected ($0.16)
Seat 3: Rummy41 (big blind) folded before Flop
Seat 4: gloommyrat folded before Flop (didn't bet)
Seat 5: Mara6111 folded before Flop (didn't bet)
Seat 6: BadBeat Bert folded before Flop (didn't bet)
Seat 7: PhilB111 folded before Flop (didn't bet)
Seat 8: ggGoldenPunk folded before Flop
Seat 9: pumpedli folded before Flop



PokerStars Zoom Hand #216383184623:  Hold'em No Limit ($0.01/$0.02) - 2020/07/13 19:30:53 CET [2020/07/13 13:30:53 ET]
Table 'McNaught' 9-max Seat #1 is the button
Seat 1: sayatsemey ($2.34 in chips) 
Seat 2: mg-deniz ($2 in chips) 
Seat 3: snow9001 ($2 in chips) 
Seat 4: Ax02882005 ($2 in chips) 
Seat 5: red_81_2009 ($1.62 in chips) 
Seat 6: TrankTank ($2 in chips) 
Seat 7: alexburton24 ($5.88 in chips) 
Seat 8: xAndrzej-K ($6.51 in chips) 
Seat 9: hurla64 ($2.17 in chips) 
mg-deniz: posts small blind $0.01
snow9001: posts big blind $0.02
*** HOLE CARDS ***
Dealt to TrankTank [Tc Kh]
Ax02882005: raises $0.04 to $0.06
red_81_2009: folds 
TrankTank: folds 
alexburton24: folds 
xAndrzej-K: folds 
hurla64: folds 
sayatsemey: folds 
mg-deniz: folds 
snow9001: folds 
Uncalled bet ($0.04) returned to Ax02882005
Ax02882005 collected $0.05 from pot
Ax02882005: doesn't show hand 
*** SUMMARY ***
Total pot $0.05 | Rake $0 
Seat 1: sayatsemey (button) folded before Flop (didn't bet)
Seat 2: mg-deniz (small blind) folded before Flop
Seat 3: snow9001 (big blind) folded before Flop
Seat 4: Ax02882005 collected ($0.05)
Seat 5: red_81_2009 folded before Flop (didn't bet)
Seat 6: TrankTank folded before Flop (didn't bet)
Seat 7: alexburton24 folded before Flop (didn't bet)
Seat 8: xAndrzej-K folded before Flop (didn't bet)
Seat 9: hurla64 folded before Flop (didn't bet)



PokerStars Zoom Hand #216383188465:  Hold'em No Limit ($0.01/$0.02) - 2020/07/13 19:31:00 CET [2020/07/13 13:31:00 ET]
Table 'McNaught' 9-max Seat #1 is the button
Seat 1: mg-deniz ($2.03 in chips) 
Seat 2: HAL VAGYOK ($2.46 in chips) 
Seat 3: papatomi4 ($2.22 in chips) 
Seat 4: cuzmich500 ($2.21 in chips) 
Seat 5: alexburton24 ($5.21 in chips) 
Seat 6: PhilB111 ($4.03 in chips) 
Seat 7: Aveena2 ($2.09 in chips) 
Seat 8: TrankTank ($2 in chips) 
Seat 9: Rummy41 ($2.63 in chips) 
HAL VAGYOK: posts small blind $0.01
papatomi4: posts big blind $0.02
*** HOLE CARDS ***
Dealt to TrankTank [4d Ac]
PhilB111 is disconnected 
cuzmich500: folds 
alexburton24: folds 
PhilB111: folds 
Aveena2: folds 
TrankTank: folds 
Rummy41: folds 
mg-deniz: folds 
HAL VAGYOK: raises $0.04 to $0.06
papatomi4: calls $0.04
*** FLOP *** [9s Jc Qc]
HAL VAGYOK: bets $0.06
papatomi4: folds 
Uncalled bet ($0.06) returned to HAL VAGYOK
HAL VAGYOK collected $0.12 from pot
HAL VAGYOK: doesn't show hand 
*** SUMMARY ***
Total pot $0.12 | Rake $0 
Board [9s Jc Qc]
Seat 1: mg-deniz (button) folded before Flop (didn't bet)
Seat 2: HAL VAGYOK (small blind) collected ($0.12)
Seat 3: papatomi4 (big blind) folded on the Flop
Seat 4: cuzmich500 folded before Flop (didn't bet)
Seat 5: alexburton24 folded before Flop (didn't bet)
Seat 6: PhilB111 folded before Flop (didn't bet)
Seat 7: Aveena2 folded before Flop (didn't bet)
Seat 8: TrankTank folded before Flop (didn't bet)
Seat 9: Rummy41 folded before Flop (didn't bet)



PokerStars Zoom Hand #216383194947:  Hold'em No Limit ($0.01/$0.02) - 2020/07/13 19:31:12 CET [2020/07/13 13:31:12 ET]
Table 'McNaught' 9-max Seat #1 is the button
Seat 1: cuzmich500 ($0.94 in chips) 
Seat 2: GrafGo999 ($2.02 in chips) 
Seat 3: TrankTank ($2 in chips) 
Seat 4: BONECA DELICADA ($1.88 in chips) 
Seat 5: AndronDJ ($6.87 in chips) 
Seat 6: PhilB111 ($2.28 in chips) 
Seat 7: linkk1075 ($8.21 in chips) 
Seat 8: Mizepa ($3.78 in chips) 
Seat 9: Selckinto ($2.20 in chips) 
GrafGo999: posts small blind $0.01
TrankTank: posts big blind $0.02
*** HOLE CARDS ***
Dealt to TrankTank [5d 4s]
BONECA DELICADA: folds 
PhilB111 is disconnected 
AndronDJ: raises $0.04 to $0.06
PhilB111: folds 
linkk1075: calls $0.06
Mizepa: folds 
Selckinto: folds 
cuzmich500: folds 
GrafGo999: folds 
TrankTank: folds 
*** FLOP *** [9h 8h Qd]
AndronDJ: checks 
linkk1075: bets $0.07
AndronDJ: calls $0.07
*** TURN *** [9h 8h Qd] [4h]
AndronDJ: checks 
linkk1075: checks 
*** RIVER *** [9h 8h Qd 4h] [5s]
AndronDJ: checks 
linkk1075: checks 
*** SHOW DOWN ***
AndronDJ: shows [Ks Js] (high card King)
linkk1075: shows [Ac Jc] (high card Ace)
linkk1075 collected $0.28 from pot
*** SUMMARY ***
Total pot $0.29 | Rake $0.01 
Board [9h 8h Qd 4h 5s]
Seat 1: cuzmich500 (button) folded before Flop (didn't bet)
Seat 2: GrafGo999 (small blind) folded before Flop
Seat 3: TrankTank (big blind) folded before Flop
Seat 4: BONECA DELICADA folded before Flop (didn't bet)
Seat 5: AndronDJ showed [Ks Js] and lost with high card King
Seat 6: PhilB111 folded before Flop (didn't bet)
Seat 7: linkk1075 showed [Ac Jc] and won ($0.28) with high card Ace
Seat 8: Mizepa folded before Flop (didn't bet)
Seat 9: Selckinto folded before Flop (didn't bet)



PokerStars Zoom Hand #216383204718:  Hold'em No Limit ($0.01/$0.02) - 2020/07/13 19:31:30 CET [2020/07/13 13:31:30 ET]
Table 'McNaught' 9-max Seat #1 is the button
Seat 1: gloommyrat ($2.76 in chips) 
Seat 2: snow9001 ($2 in chips) 
Seat 3: Dows&Poker ($2.22 in chips) 
Seat 4: xAndrzej-K ($6.54 in chips) 
Seat 5: Thisisnotme712 ($2 in chips) 
Seat 6: TrankTank ($2 in chips) 
Seat 7: HAL VAGYOK ($2.52 in chips) 
Seat 8: oanhoanh ($2.83 in chips) 
Seat 9: Pentonomix ($1 in chips) 
snow9001: posts small blind $0.01
Dows&Poker: posts big blind $0.02
*** HOLE CARDS ***
Dealt to TrankTank [9h Js]
xAndrzej-K: folds 
Thisisnotme712: folds 
TrankTank: folds 
HAL VAGYOK: folds 
oanhoanh: folds 
Pentonomix: raises $0.04 to $0.06
gloommyrat: folds 
snow9001: raises $0.11 to $0.17
Dows&Poker: folds 
Pentonomix: raises $0.25 to $0.42
snow9001: folds 
Uncalled bet ($0.25) returned to Pentonomix
Pentonomix collected $0.36 from pot
Pentonomix: doesn't show hand 
*** SUMMARY ***
Total pot $0.36 | Rake $0 
Seat 1: gloommyrat (button) folded before Flop (didn't bet)
Seat 2: snow9001 (small blind) folded before Flop
Seat 3: Dows&Poker (big blind) folded before Flop
Seat 4: xAndrzej-K folded before Flop (didn't bet)
Seat 5: Thisisnotme712 folded before Flop (didn't bet)
Seat 6: TrankTank folded before Flop (didn't bet)
Seat 7: HAL VAGYOK folded before Flop (didn't bet)
Seat 8: oanhoanh folded before Flop (didn't bet)
Seat 9: Pentonomix collected ($0.36)



PokerStars Zoom Hand #216383209670:  Hold'em No Limit ($0.01/$0.02) - 2020/07/13 19:31:39 CET [2020/07/13 13:31:39 ET]
Table 'McNaught' 9-max Seat #1 is the button
Seat 1: TheBlade8525 ($4.66 in chips) 
Seat 2: TrankTank ($2 in chips) 
Seat 3: Dambouski Y ($2 in chips) 
Seat 4: niko16321 ($1.72 in chips) 
Seat 5: Scorpi0n777 ($2.24 in chips) 
Seat 6: Vulcan615 ($0.95 in chips) 
Seat 7: gloommyrat ($2.76 in chips) 
Seat 8: sczurek19681 ($3.05 in chips) 
Seat 9: pocoyo088 ($2.17 in chips) 
TrankTank: posts small blind $0.01
Dambouski Y: posts big blind $0.02
*** HOLE CARDS ***
Dealt to TrankTank [3d 3h]
niko16321: folds 
Scorpi0n777: folds 
Vulcan615: folds 
gloommyrat: raises $0.04 to $0.06
sczurek19681: folds 
pocoyo088: folds 
TheBlade8525: calls $0.06
TrankTank: calls $0.05
Dambouski Y: folds 
*** FLOP *** [Js 9s Ks]
TrankTank: checks 
gloommyrat: checks 
TheBlade8525: checks 
*** TURN *** [Js 9s Ks] [6c]
TrankTank: checks 
gloommyrat: checks 
TheBlade8525: checks 
*** RIVER *** [Js 9s Ks 6c] [Kd]
TrankTank: checks 
gloommyrat: checks 
TheBlade8525: checks 
*** SHOW DOWN ***
TrankTank: shows [3d 3h] (two pair, Kings and Threes)
gloommyrat: shows [8h 8d] (two pair, Kings and Eights)
TheBlade8525: mucks hand 
gloommyrat collected $0.19 from pot
*** SUMMARY ***
Total pot $0.20 | Rake $0.01 
Board [Js 9s Ks 6c Kd]
Seat 1: TheBlade8525 (button) mucked [Qd Ac]
Seat 2: TrankTank (small blind) showed [3d 3h] and lost with two pair, Kings and Threes
Seat 3: Dambouski Y (big blind) folded before Flop
Seat 4: niko16321 folded before Flop (didn't bet)
Seat 5: Scorpi0n777 folded before Flop (didn't bet)
Seat 6: Vulcan615 folded before Flop (didn't bet)
Seat 7: gloommyrat showed [8h 8d] and won ($0.19) with two pair, Kings and Eights
Seat 8: sczurek19681 folded before Flop (didn't bet)
Seat 9: pocoyo088 folded before Flop (didn't bet)



PokerStars Zoom Hand #216383240289:  Hold'em No Limit ($0.01/$0.02) - 2020/07/13 19:32:35 CET [2020/07/13 13:32:35 ET]
Table 'McNaught' 9-max Seat #1 is the button
Seat 1: TrankTank ($2 in chips) 
Seat 2: red_81_2009 ($1.42 in chips) 
Seat 3: STYNG01 ($6.09 in chips) 
Seat 4: gloommyrat ($2.89 in chips) 
Seat 5: 21041956 ($1.02 in chips) 
Seat 6: tomashovka55 ($2 in chips) 
Seat 7: TheBlade8525 ($4.60 in chips) 
Seat 8: dmitrychuk ($4.84 in chips) 
Seat 9: PhilB111 ($2 in chips) 
red_81_2009: posts small blind $0.01
STYNG01: posts big blind $0.02
*** HOLE CARDS ***
Dealt to TrankTank [Qh 5c]
gloommyrat: folds 
21041956: folds 
PhilB111 is disconnected 
tomashovka55: folds 
TheBlade8525: folds 
dmitrychuk: folds 
PhilB111: folds 
TrankTank: folds 
red_81_2009: raises $0.02 to $0.04
STYNG01: folds 
Uncalled bet ($0.02) returned to red_81_2009
red_81_2009 collected $0.04 from pot
red_81_2009: doesn't show hand 
*** SUMMARY ***
Total pot $0.04 | Rake $0 
Seat 1: TrankTank (button) folded before Flop (didn't bet)
Seat 2: red_81_2009 (small blind) collected ($0.04)
Seat 3: STYNG01 (big blind) folded before Flop
Seat 4: gloommyrat folded before Flop (didn't bet)
Seat 5: 21041956 folded before Flop (didn't bet)
Seat 6: tomashovka55 folded before Flop (didn't bet)
Seat 7: TheBlade8525 folded before Flop (didn't bet)
Seat 8: dmitrychuk folded before Flop (didn't bet)
Seat 9: PhilB111 folded before Flop (didn't bet)



PokerStars Zoom Hand #216383247384:  Hold'em No Limit ($0.01/$0.02) - 2020/07/13 19:32:48 CET [2020/07/13 13:32:48 ET]
Table 'McNaught' 9-max Seat #1 is the button
Seat 1: WilFred.ru ($1.81 in chips) 
Seat 2: Aveena2 ($2 in chips) 
Seat 3: Petrovich-95 ($1 in chips) 
Seat 4: Iron208 ($2 in chips) 
Seat 5: gesaes ($2.30 in chips) 
Seat 6: tomashovka55 ($2 in chips) 
Seat 7: eNtErStAr ($2 in chips) 
Seat 8: xAndrzej-K ($6.49 in chips) 
Seat 9: TrankTank ($2 in chips) 
Aveena2: posts small blind $0.01
Petrovich-95: posts big blind $0.02
*** HOLE CARDS ***
Dealt to TrankTank [Ad 7s]
Iron208: folds 
gesaes: folds 
tomashovka55: folds 
eNtErStAr: folds 
xAndrzej-K: calls $0.02
TrankTank: folds 
WilFred.ru: folds 
Aveena2: folds 
Petrovich-95: checks 
*** FLOP *** [Ah Qh 6d]
Petrovich-95: checks 
xAndrzej-K: bets $0.05
Petrovich-95: raises $0.05 to $0.10
xAndrzej-K: calls $0.05
*** TURN *** [Ah Qh 6d] [Jh]
Petrovich-95: checks 
xAndrzej-K: checks 
*** RIVER *** [Ah Qh 6d Jh] [3s]
Petrovich-95: checks 
xAndrzej-K: checks 
*** SHOW DOWN ***
Petrovich-95: shows [Kh 6s] (a pair of Sixes)
xAndrzej-K: shows [8c Ac] (a pair of Aces)
xAndrzej-K collected $0.24 from pot
*** SUMMARY ***
Total pot $0.25 | Rake $0.01 
Board [Ah Qh 6d Jh 3s]
Seat 1: WilFred.ru (button) folded before Flop (didn't bet)
Seat 2: Aveena2 (small blind) folded before Flop
Seat 3: Petrovich-95 (big blind) showed [Kh 6s] and lost with a pair of Sixes
Seat 4: Iron208 folded before Flop (didn't bet)
Seat 5: gesaes folded before Flop (didn't bet)
Seat 6: tomashovka55 folded before Flop (didn't bet)
Seat 7: eNtErStAr folded before Flop (didn't bet)
Seat 8: xAndrzej-K showed [8c Ac] and won ($0.24) with a pair of Aces
Seat 9: TrankTank folded before Flop (didn't bet)



PokerStars Zoom Hand #216383253412:  Hold'em No Limit ($0.01/$0.02) - 2020/07/13 19:32:59 CET [2020/07/13 13:32:59 ET]
Table 'McNaught' 9-max Seat #1 is the button
Seat 1: pumpedli ($2 in chips) 
Seat 2: BONECA DELICADA ($1.85 in chips) 
Seat 3: 21041956 ($1 in chips) 
Seat 4: Iron208 ($2 in chips) 
Seat 5: Aveena2 ($2.09 in chips) 
Seat 6: joehlavicka ($1.86 in chips) 
Seat 7: TrankTank ($2 in chips) 
Seat 8: pisqnek ($1.99 in chips) 
Seat 9: GaliRah ($2.18 in chips) 
BONECA DELICADA: posts small blind $0.01
21041956: posts big blind $0.02
*** HOLE CARDS ***
Dealt to TrankTank [9h Kh]
Iron208: folds 
Aveena2: folds 
joehlavicka has timed out
joehlavicka: folds 
TrankTank: folds 
pisqnek: folds 
GaliRah: folds 
pumpedli: raises $0.04 to $0.06
BONECA DELICADA: folds 
21041956: raises $0.94 to $1 and is all-in
pumpedli: folds 
Uncalled bet ($0.94) returned to 21041956
21041956 collected $0.13 from pot
21041956: doesn't show hand 
*** SUMMARY ***
Total pot $0.13 | Rake $0 
Seat 1: pumpedli (button) folded before Flop
Seat 2: BONECA DELICADA (small blind) folded before Flop
Seat 3: 21041956 (big blind) collected ($0.13)
Seat 4: Iron208 folded before Flop (didn't bet)
Seat 5: Aveena2 folded before Flop (didn't bet)
Seat 6: joehlavicka folded before Flop (didn't bet)
Seat 7: TrankTank folded before Flop (didn't bet)
Seat 8: pisqnek folded before Flop (didn't bet)
Seat 9: GaliRah folded before Flop (didn't bet)



PokerStars Zoom Hand #216383263839:  Hold'em No Limit ($0.01/$0.02) - 2020/07/13 19:33:18 CET [2020/07/13 13:33:18 ET]
Table 'McNaught' 9-max Seat #1 is the button
Seat 1: BLEF1973 ($9.50 in chips) 
Seat 2: sayatsemey ($1.76 in chips) 
Seat 3: luda555 ($1.02 in chips) 
Seat 4: Dambouski Y ($2 in chips) 
Seat 5: TrankTank ($2 in chips) 
Seat 6: Dows&Poker ($2.13 in chips) 
Seat 7: hurla64 ($10.81 in chips) 
Seat 8: Aveena2 ($2.09 in chips) 
Seat 9: wraggy225 ($2.01 in chips) 
sayatsemey: posts small blind $0.01
luda555: posts big blind $0.02
*** HOLE CARDS ***
Dealt to TrankTank [3h Ts]
Dambouski Y: folds 
TrankTank: folds 
Dows&Poker: folds 
hurla64: folds 
Aveena2: folds 
wraggy225: raises $0.05 to $0.07
BLEF1973: folds 
sayatsemey: folds 
luda555: folds 
Uncalled bet ($0.05) returned to wraggy225
wraggy225 collected $0.05 from pot
wraggy225: doesn't show hand 
*** SUMMARY ***
Total pot $0.05 | Rake $0 
Seat 1: BLEF1973 (button) folded before Flop (didn't bet)
Seat 2: sayatsemey (small blind) folded before Flop
Seat 3: luda555 (big blind) folded before Flop
Seat 4: Dambouski Y folded before Flop (didn't bet)
Seat 5: TrankTank folded before Flop (didn't bet)
Seat 6: Dows&Poker folded before Flop (didn't bet)
Seat 7: hurla64 folded before Flop (didn't bet)
Seat 8: Aveena2 folded before Flop (didn't bet)
Seat 9: wraggy225 collected ($0.05)



PokerStars Zoom Hand #216383270940:  Hold'em No Limit ($0.01/$0.02) - 2020/07/13 19:33:31 CET [2020/07/13 13:33:31 ET]
Table 'McNaught' 9-max Seat #1 is the button
Seat 1: sayatsemey ($1.75 in chips) 
Seat 2: hurla64 ($4.94 in chips) 
Seat 3: Raketa57 ($13.21 in chips) 
Seat 4: TrankTank ($2 in chips) 
Seat 5: Climax82 ($1.44 in chips) 
Seat 6: hoss145 ($2.08 in chips) 
Seat 7: Mara6111 ($3.38 in chips) 
Seat 8: snow9001 ($2 in chips) 
Seat 9: 21041956 ($1.07 in chips) 
hurla64: posts small blind $0.01
Raketa57: posts big blind $0.02
*** HOLE CARDS ***
Dealt to TrankTank [Jd 3c]
TrankTank: folds 
Climax82: folds 
hoss145: raises $0.02 to $0.04
Mara6111: folds 
snow9001: folds 
21041956: folds 
sayatsemey: raises $0.02 to $0.06
hurla64: folds 
Raketa57: calls $0.04
hoss145: calls $0.02
*** FLOP *** [8s 6h 4c]
Raketa57: checks 
hoss145: checks 
sayatsemey: bets $0.16
Raketa57: folds 
hoss145: folds 
Uncalled bet ($0.16) returned to sayatsemey
sayatsemey collected $0.18 from pot
sayatsemey: doesn't show hand 
*** SUMMARY ***
Total pot $0.19 | Rake $0.01 
Board [8s 6h 4c]
Seat 1: sayatsemey (button) collected ($0.18)
Seat 2: hurla64 (small blind) folded before Flop
Seat 3: Raketa57 (big blind) folded on the Flop
Seat 4: TrankTank folded before Flop (didn't bet)
Seat 5: Climax82 folded before Flop (didn't bet)
Seat 6: hoss145 folded on the Flop
Seat 7: Mara6111 folded before Flop (didn't bet)
Seat 8: snow9001 folded before Flop (didn't bet)
Seat 9: 21041956 folded before Flop (didn't bet)



PokerStars Zoom Hand #216383267701:  Hold'em No Limit ($0.01/$0.02) - 2020/07/13 19:33:25 CET [2020/07/13 13:33:25 ET]
Table 'McNaught' 9-max Seat #1 is the button
Seat 1: jonick17 ($1.63 in chips) 
Seat 2: givinfree$ ($4.27 in chips) 
Seat 3: Marmelicious ($2.18 in chips) 
Seat 4: niko16321 ($1.75 in chips) 
Seat 5: TrankTank ($2 in chips) 
Seat 6: cuzmich500 ($1 in chips) 
Seat 7: Krimil ($2.08 in chips) 
Seat 8: linkk1075 ($8.26 in chips) 
Seat 9: gesaes ($2.29 in chips) 
givinfree$: posts small blind $0.01
Marmelicious: posts big blind $0.02
*** HOLE CARDS ***
Dealt to TrankTank [5h Qd]
niko16321: folds 
TrankTank: folds 
cuzmich500: raises $0.04 to $0.06
Krimil: calls $0.06
linkk1075: folds 
gesaes: folds 
jonick17: folds 
givinfree$: folds 
Marmelicious: folds 
*** FLOP *** [9d Js Jc]
cuzmich500: checks 
Krimil: checks 
*** TURN *** [9d Js Jc] [Qs]
cuzmich500: checks 
Krimil: checks 
*** RIVER *** [9d Js Jc Qs] [2c]
cuzmich500: checks 
Krimil: checks 
*** SHOW DOWN ***
cuzmich500: shows [Ks Ad] (a pair of Jacks)
Krimil: shows [3s 3h] (two pair, Jacks and Threes)
Krimil collected $0.14 from pot
*** SUMMARY ***
Total pot $0.15 | Rake $0.01 
Board [9d Js Jc Qs 2c]
Seat 1: jonick17 (button) folded before Flop (didn't bet)
Seat 2: givinfree$ (small blind) folded before Flop
Seat 3: Marmelicious (big blind) folded before Flop
Seat 4: niko16321 folded before Flop (didn't bet)
Seat 5: TrankTank folded before Flop (didn't bet)
Seat 6: cuzmich500 showed [Ks Ad] and lost with a pair of Jacks
Seat 7: Krimil showed [3s 3h] and won ($0.14) with two pair, Jacks and Threes
Seat 8: linkk1075 folded before Flop (didn't bet)
Seat 9: gesaes folded before Flop (didn't bet)



PokerStars Zoom Hand #216383273715:  Hold'em No Limit ($0.01/$0.02) - 2020/07/13 19:33:36 CET [2020/07/13 13:33:36 ET]
Table 'McNaught' 9-max Seat #1 is the button
Seat 1: pumpedli ($2.38 in chips) 
Seat 2: Elvis ah ha ($1.72 in chips) 
Seat 3: TrankTank ($2 in chips) 
Seat 4: Mizepa ($2 in chips) 
Seat 5: alosksora ($2 in chips) 
Seat 6: Iron208 ($2 in chips) 
Seat 7: ZOLOTOW ($1.08 in chips) 
Seat 8: hurla64 ($2.24 in chips) 
Seat 9: linkk1075 ($8.26 in chips) 
Elvis ah ha: posts small blind $0.01
TrankTank: posts big blind $0.02
*** HOLE CARDS ***
Dealt to TrankTank [Jc Kc]
Mizepa: folds 
alosksora: raises $0.02 to $0.04
Iron208: folds 
ZOLOTOW: folds 
hurla64: folds 
linkk1075: folds 
pumpedli: calls $0.04
Elvis ah ha: folds 
TrankTank: calls $0.02
*** FLOP *** [Kd Qs Jd]
TrankTank: bets $0.09
alosksora: calls $0.09
pumpedli: folds 
*** TURN *** [Kd Qs Jd] [6d]
TrankTank: bets $0.21
alosksora: calls $0.21
*** RIVER *** [Kd Qs Jd 6d] [3s]
TrankTank: bets $0.49
alosksora: raises $0.49 to $0.98
TrankTank: calls $0.49
*** SHOW DOWN ***
alosksora: shows [9d Td] (a flush, King high)
TrankTank: mucks hand 
alosksora collected $2.60 from pot
*** SUMMARY ***
Total pot $2.69 | Rake $0.09 
Board [Kd Qs Jd 6d 3s]
Seat 1: pumpedli (button) folded on the Flop
Seat 2: Elvis ah ha (small blind) folded before Flop
Seat 3: TrankTank (big blind) mucked [Jc Kc]
Seat 4: Mizepa folded before Flop (didn't bet)
Seat 5: alosksora showed [9d Td] and won ($2.60) with a flush, King high
Seat 6: Iron208 folded before Flop (didn't bet)
Seat 7: ZOLOTOW folded before Flop (didn't bet)
Seat 8: hurla64 folded before Flop (didn't bet)
Seat 9: linkk1075 folded before Flop (didn't bet)



PokerStars Zoom Hand #216383314895:  Hold'em No Limit ($0.01/$0.02) - 2020/07/13 19:34:51 CET [2020/07/13 13:34:51 ET]
Table 'McNaught' 9-max Seat #1 is the button
Seat 1: 21041956 ($1.13 in chips) 
Seat 2: TrankTank ($2 in chips) 
Seat 3: BRENOMACHADO ($0.68 in chips) 
Seat 4: joehlavicka ($2.22 in chips) 
Seat 5: Fostal_by ($2 in chips) 
Seat 6: niko16321 ($1.81 in chips) 
Seat 7: Petrovich-95 ($0.87 in chips) 
Seat 8: dmitrychuk ($4.66 in chips) 
Seat 9: alosksora ($3.28 in chips) 
TrankTank: posts small blind $0.01
BRENOMACHADO: posts big blind $0.02
*** HOLE CARDS ***
Dealt to TrankTank [4h 7h]
joehlavicka: folds 
Fostal_by: folds 
niko16321: folds 
Petrovich-95: folds 
dmitrychuk: raises $0.04 to $0.06
alosksora: folds 
21041956: folds 
TrankTank: folds 
BRENOMACHADO: folds 
Uncalled bet ($0.04) returned to dmitrychuk
dmitrychuk collected $0.05 from pot
dmitrychuk: doesn't show hand 
*** SUMMARY ***
Total pot $0.05 | Rake $0 
Seat 1: 21041956 (button) folded before Flop (didn't bet)
Seat 2: TrankTank (small blind) folded before Flop
Seat 3: BRENOMACHADO (big blind) folded before Flop
Seat 4: joehlavicka folded before Flop (didn't bet)
Seat 5: Fostal_by folded before Flop (didn't bet)
Seat 6: niko16321 folded before Flop (didn't bet)
Seat 7: Petrovich-95 folded before Flop (didn't bet)
Seat 8: dmitrychuk collected ($0.05)
Seat 9: alosksora folded before Flop (didn't bet)



PokerStars Zoom Hand #216383324045:  Hold'em No Limit ($0.01/$0.02) - 2020/07/13 19:35:08 CET [2020/07/13 13:35:08 ET]
Table 'McNaught' 9-max Seat #1 is the button
Seat 1: Iron208 ($2.13 in chips) 
Seat 2: PhilB111 ($4.02 in chips) 
Seat 3: sayatsemey ($3.03 in chips) 
Seat 4: Krimil ($2.54 in chips) 
Seat 5: TheBlade8525 ($4.42 in chips) 
Seat 6: oanhoanh ($2.76 in chips) 
Seat 7: pisqnek ($4.72 in chips) 
Seat 8: TrankTank ($2 in chips) 
Seat 9: sczurek19681 ($2.65 in chips) 
PhilB111: posts small blind $0.01
sayatsemey: posts big blind $0.02
*** HOLE CARDS ***
Dealt to TrankTank [6c Jc]
Krimil: raises $0.02 to $0.04
PhilB111 is disconnected 
TheBlade8525: folds 
oanhoanh: folds 
pisqnek: raises $0.11 to $0.15
TrankTank: folds 
sczurek19681: folds 
Iron208: folds 
PhilB111: folds 
sayatsemey: folds 
Krimil: folds 
Uncalled bet ($0.11) returned to pisqnek
pisqnek collected $0.11 from pot
pisqnek: doesn't show hand 
*** SUMMARY ***
Total pot $0.11 | Rake $0 
Seat 1: Iron208 (button) folded before Flop (didn't bet)
Seat 2: PhilB111 (small blind) folded before Flop
Seat 3: sayatsemey (big blind) folded before Flop
Seat 4: Krimil folded before Flop
Seat 5: TheBlade8525 folded before Flop (didn't bet)
Seat 6: oanhoanh folded before Flop (didn't bet)
Seat 7: pisqnek collected ($0.11)
Seat 8: TrankTank folded before Flop (didn't bet)
Seat 9: sczurek19681 folded before Flop (didn't bet)



PokerStars Zoom Hand #216383348293:  Hold'em No Limit ($0.01/$0.02) - 2020/07/13 19:35:52 CET [2020/07/13 13:35:52 ET]
Table 'McNaught' 9-max Seat #1 is the button
Seat 1: HAL VAGYOK ($8.71 in chips) 
Seat 2: Aveena2 ($2 in chips) 
Seat 3: Mizepa ($3.96 in chips) 
Seat 4: ggGoldenPunk ($4.13 in chips) 
Seat 5: CÉZ@R ($1.34 in chips) 
Seat 6: cuzmich500 ($0.99 in chips) 
Seat 7: TrankTank ($2 in chips) 
Seat 8: TheBlade8525 ($4.44 in chips) 
Seat 9: Nimajuan ($1.51 in chips) 
Aveena2: posts small blind $0.01
Mizepa: posts big blind $0.02
*** HOLE CARDS ***
Dealt to TrankTank [4h Kh]
Nimajuan is disconnected 
ggGoldenPunk: folds 
CÉZ@R: folds 
cuzmich500: folds 
TrankTank: folds 
TheBlade8525: folds 
Nimajuan: folds 
HAL VAGYOK: folds 
Aveena2: folds 
Uncalled bet ($0.01) returned to Mizepa
Mizepa collected $0.02 from pot
Mizepa: doesn't show hand 
*** SUMMARY ***
Total pot $0.02 | Rake $0 
Seat 1: HAL VAGYOK (button) folded before Flop (didn't bet)
Seat 2: Aveena2 (small blind) folded before Flop
Seat 3: Mizepa (big blind) collected ($0.02)
Seat 4: ggGoldenPunk folded before Flop (didn't bet)
Seat 5: CÉZ@R folded before Flop (didn't bet)
Seat 6: cuzmich500 folded before Flop (didn't bet)
Seat 7: TrankTank folded before Flop (didn't bet)
Seat 8: TheBlade8525 folded before Flop (didn't bet)
Seat 9: Nimajuan folded before Flop (didn't bet)



PokerStars Zoom Hand #216383335577:  Hold'em No Limit ($0.01/$0.02) - 2020/07/13 19:35:29 CET [2020/07/13 13:35:29 ET]
Table 'McNaught' 9-max Seat #1 is the button
Seat 1: TrankTank ($2 in chips) 
Seat 2: alosksora ($3.26 in chips) 
Seat 3: shaimovich ($1.75 in chips) 
Seat 4: jackbam993 ($0.98 in chips) 
Seat 5: 21041956 ($1.22 in chips) 
Seat 6: givinfree$ ($4.17 in chips) 
Seat 7: vasyara26 ($1.21 in chips) 
Seat 8: sayatsemey ($1.96 in chips) 
Seat 9: pumpedli ($2.33 in chips) 
alosksora: posts small blind $0.01
shaimovich: posts big blind $0.02
*** HOLE CARDS ***
Dealt to TrankTank [3c Th]
jackbam993: folds 
21041956: calls $0.02
givinfree$: folds 
vasyara26: calls $0.02
sayatsemey: raises $0.04 to $0.06
pumpedli: folds 
TrankTank: folds 
alosksora: folds 
shaimovich: folds 
21041956: calls $0.04
vasyara26: calls $0.04
*** FLOP *** [Ts 7s 7c]
21041956: bets $1.16 and is all-in
vasyara26: folds 
sayatsemey: folds 
Uncalled bet ($1.16) returned to 21041956
21041956 collected $0.20 from pot
21041956: doesn't show hand 
*** SUMMARY ***
Total pot $0.21 | Rake $0.01 
Board [Ts 7s 7c]
Seat 1: TrankTank (button) folded before Flop (didn't bet)
Seat 2: alosksora (small blind) folded before Flop
Seat 3: shaimovich (big blind) folded before Flop
Seat 4: jackbam993 folded before Flop (didn't bet)
Seat 5: 21041956 collected ($0.20)
Seat 6: givinfree$ folded before Flop (didn't bet)
Seat 7: vasyara26 folded on the Flop
Seat 8: sayatsemey folded on the Flop
Seat 9: pumpedli folded before Flop (didn't bet)



PokerStars Zoom Hand #216383361977:  Hold'em No Limit ($0.01/$0.02) - 2020/07/13 19:36:17 CET [2020/07/13 13:36:17 ET]
Table 'McNaught' 9-max Seat #1 is the button
Seat 1: Tiggu ($0.95 in chips) 
Seat 2: Dambouski Y ($2.01 in chips) 
Seat 3: stiefidi ($1.12 in chips) 
Seat 4: PhilB111 ($2.19 in chips) 
Seat 5: Iron208 ($2.11 in chips) 
Seat 6: TrankTank ($2 in chips) 
Seat 7: BLEF1973 ($8.01 in chips) 
Seat 8: FelixFerrari ($1.17 in chips) 
Seat 9: canxuh ($1.92 in chips) 
Dambouski Y: posts small blind $0.01
stiefidi: posts big blind $0.02
*** HOLE CARDS ***
Dealt to TrankTank [Th Qd]
PhilB111: folds 
Iron208: folds 
PhilB111 is disconnected 
TrankTank: folds 
BLEF1973: folds 
FelixFerrari: folds 
canxuh: folds 
Tiggu: folds 
Dambouski Y: folds 
Uncalled bet ($0.01) returned to stiefidi
stiefidi collected $0.02 from pot
stiefidi: doesn't show hand 
*** SUMMARY ***
Total pot $0.02 | Rake $0 
Seat 1: Tiggu (button) folded before Flop (didn't bet)
Seat 2: Dambouski Y (small blind) folded before Flop
Seat 3: stiefidi (big blind) collected ($0.02)
Seat 4: PhilB111 folded before Flop (didn't bet)
Seat 5: Iron208 folded before Flop (didn't bet)
Seat 6: TrankTank folded before Flop (didn't bet)
Seat 7: BLEF1973 folded before Flop (didn't bet)
Seat 8: FelixFerrari folded before Flop (didn't bet)
Seat 9: canxuh folded before Flop (didn't bet)



PokerStars Zoom Hand #216383357577:  Hold'em No Limit ($0.01/$0.02) - 2020/07/13 19:36:09 CET [2020/07/13 13:36:09 ET]
Table 'McNaught' 9-max Seat #1 is the button
Seat 1: Mizepa ($3.97 in chips) 
Seat 2: cuzmich500 ($0.97 in chips) 
Seat 3: sayatsemey ($1.90 in chips) 
Seat 4: givinfree$ ($4.15 in chips) 
Seat 5: Dows&Poker ($2.11 in chips) 
Seat 6: pisqnek ($1.89 in chips) 
Seat 7: Baggio198910 ($1.80 in chips) 
Seat 8: STYNG01 ($9.10 in chips) 
Seat 9: TrankTank ($2 in chips) 
cuzmich500: posts small blind $0.01
sayatsemey: posts big blind $0.02
*** HOLE CARDS ***
Dealt to TrankTank [4s Td]
givinfree$: folds 
Dows&Poker: folds 
pisqnek: folds 
Baggio198910: folds 
STYNG01: folds 
TrankTank: folds 
Mizepa: raises $0.03 to $0.05
cuzmich500: calls $0.04
sayatsemey: calls $0.03
*** FLOP *** [4c Ts 5d]
cuzmich500: checks 
sayatsemey: bets $0.10
Mizepa: calls $0.10
cuzmich500: folds 
*** TURN *** [4c Ts 5d] [4d]
sayatsemey: bets $0.17
Mizepa: calls $0.17
*** RIVER *** [4c Ts 5d 4d] [9h]
sayatsemey: bets $0.44
Mizepa: folds 
Uncalled bet ($0.44) returned to sayatsemey
sayatsemey collected $0.67 from pot
sayatsemey: doesn't show hand 
*** SUMMARY ***
Total pot $0.69 | Rake $0.02 
Board [4c Ts 5d 4d 9h]
Seat 1: Mizepa (button) folded on the River
Seat 2: cuzmich500 (small blind) folded on the Flop
Seat 3: sayatsemey (big blind) collected ($0.67)
Seat 4: givinfree$ folded before Flop (didn't bet)
Seat 5: Dows&Poker folded before Flop (didn't bet)
Seat 6: pisqnek folded before Flop (didn't bet)
Seat 7: Baggio198910 folded before Flop (didn't bet)
Seat 8: STYNG01 folded before Flop (didn't bet)
Seat 9: TrankTank folded before Flop (didn't bet)



PokerStars Zoom Hand #216383366404:  Hold'em No Limit ($0.01/$0.02) - 2020/07/13 19:36:25 CET [2020/07/13 13:36:25 ET]
Table 'McNaught' 9-max Seat #1 is the button
Seat 1: FelixFerrari ($1.17 in chips) 
Seat 2: pumpedli ($2.31 in chips) 
Seat 3: Nimajuan ($1.51 in chips) 
Seat 4: alosksora ($3.25 in chips) 
Seat 5: TrankTank ($2 in chips) 
Seat 6: sczurek19681 ($2.54 in chips) 
Seat 7: givinfree$ ($2.52 in chips) 
Seat 8: gloommyrat ($2.69 in chips) 
Seat 9: Iron208 ($2.07 in chips) 
pumpedli: posts small blind $0.01
Nimajuan: posts big blind $0.02
*** HOLE CARDS ***
Dealt to TrankTank [Jd Js]
alosksora: calls $0.02
TrankTank: raises $0.05 to $0.07
sczurek19681: folds 
givinfree$: folds 
gloommyrat: folds 
Iron208: folds 
Nimajuan is disconnected 
FelixFerrari: folds 
pumpedli: folds 
Nimajuan: folds 
alosksora: calls $0.05
*** FLOP *** [9s 9c Ac]
alosksora: checks 
TrankTank: bets $0.11
alosksora: calls $0.11
*** TURN *** [9s 9c Ac] [Ad]
alosksora: bets $0.02
TrankTank: calls $0.02
*** RIVER *** [9s 9c Ac Ad] [8c]
alosksora: bets $0.24
TrankTank: folds 
Uncalled bet ($0.24) returned to alosksora
alosksora collected $0.41 from pot
alosksora: doesn't show hand 
*** SUMMARY ***
Total pot $0.43 | Rake $0.02 
Board [9s 9c Ac Ad 8c]
Seat 1: FelixFerrari (button) folded before Flop (didn't bet)
Seat 2: pumpedli (small blind) folded before Flop
Seat 3: Nimajuan (big blind) folded before Flop
Seat 4: alosksora collected ($0.41)
Seat 5: TrankTank folded on the River
Seat 6: sczurek19681 folded before Flop (didn't bet)
Seat 7: givinfree$ folded before Flop (didn't bet)
Seat 8: gloommyrat folded before Flop (didn't bet)
Seat 9: Iron208 folded before Flop (didn't bet)



PokerStars Zoom Hand #216383414293:  Hold'em No Limit ($0.01/$0.02) - 2020/07/13 19:37:52 CET [2020/07/13 13:37:52 ET]
Table 'McNaught' 9-max Seat #1 is the button
Seat 1: dzhonijs_e ($2.38 in chips) 
Seat 2: gloommyrat ($2 in chips) 
Seat 3: cuzmich500 ($1.59 in chips) 
Seat 4: Nimajuan ($1.53 in chips) 
Seat 5: TrankTank ($2 in chips) 
Seat 6: snow9001 ($2.83 in chips) 
Seat 7: Krimil ($2.53 in chips) 
Seat 8: Skydomes ($2.53 in chips) 
Seat 9: linkk1075 ($10.93 in chips) 
gloommyrat: posts small blind $0.01
cuzmich500: posts big blind $0.02
*** HOLE CARDS ***
Dealt to TrankTank [Qd Js]
Nimajuan: folds 
Nimajuan is disconnected 
TrankTank: raises $0.04 to $0.06
snow9001: folds 
Krimil: raises $0.06 to $0.12
Skydomes: folds 
linkk1075: folds 
dzhonijs_e: folds 
gloommyrat: folds 
cuzmich500: folds 
TrankTank: calls $0.06
*** FLOP *** [6c Ac 9d]
TrankTank: bets $0.18
Krimil: calls $0.18
*** TURN *** [6c Ac 9d] [Jc]
TrankTank: checks 
Krimil: checks 
*** RIVER *** [6c Ac 9d Jc] [Qs]
TrankTank: bets $0.61
Krimil: calls $0.61
*** SHOW DOWN ***
TrankTank: shows [Qd Js] (two pair, Queens and Jacks)
Krimil: shows [Ah Qc] (two pair, Aces and Queens)
Krimil collected $1.79 from pot
*** SUMMARY ***
Total pot $1.85 | Rake $0.06 
Board [6c Ac 9d Jc Qs]
Seat 1: dzhonijs_e (button) folded before Flop (didn't bet)
Seat 2: gloommyrat (small blind) folded before Flop
Seat 3: cuzmich500 (big blind) folded before Flop
Seat 4: Nimajuan folded before Flop (didn't bet)
Seat 5: TrankTank showed [Qd Js] and lost with two pair, Queens and Jacks
Seat 6: snow9001 folded before Flop (didn't bet)
Seat 7: Krimil showed [Ah Qc] and won ($1.79) with two pair, Aces and Queens
Seat 8: Skydomes folded before Flop (didn't bet)
Seat 9: linkk1075 folded before Flop (didn't bet)



PokerStars Zoom Hand #216383448005:  Hold'em No Limit ($0.01/$0.02) - 2020/07/13 19:38:53 CET [2020/07/13 13:38:53 ET]
Table 'McNaught' 9-max Seat #1 is the button
Seat 1: sczurek19681 ($2.65 in chips) 
Seat 2: Mizepa ($3.75 in chips) 
Seat 3: red_81_2009 ($1.75 in chips) 
Seat 4: TrankTank ($2 in chips) 
Seat 5: dzhonijs_e ($2.35 in chips) 
Seat 6: Iron208 ($2 in chips) 
Seat 7: pisqnek ($3.06 in chips) 
Seat 8: nnahueln ($1.51 in chips) 
Seat 9: gesaes ($2.29 in chips) 
Mizepa: posts small blind $0.01
red_81_2009: posts big blind $0.02
*** HOLE CARDS ***
Dealt to TrankTank [2d Tc]
TrankTank: folds 
dzhonijs_e: folds 
Iron208: folds 
pisqnek has timed out
pisqnek: folds 
nnahueln: folds 
gesaes: folds 
sczurek19681: folds 
Mizepa: raises $0.04 to $0.06
red_81_2009: folds 
Uncalled bet ($0.04) returned to Mizepa
Mizepa collected $0.04 from pot
Mizepa: doesn't show hand 
*** SUMMARY ***
Total pot $0.04 | Rake $0 
Seat 1: sczurek19681 (button) folded before Flop (didn't bet)
Seat 2: Mizepa (small blind) collected ($0.04)
Seat 3: red_81_2009 (big blind) folded before Flop
Seat 4: TrankTank folded before Flop (didn't bet)
Seat 5: dzhonijs_e folded before Flop (didn't bet)
Seat 6: Iron208 folded before Flop (didn't bet)
Seat 7: pisqnek folded before Flop (didn't bet)
Seat 8: nnahueln folded before Flop (didn't bet)
Seat 9: gesaes folded before Flop (didn't bet)



PokerStars Zoom Hand #216383450740:  Hold'em No Limit ($0.01/$0.02) - 2020/07/13 19:38:58 CET [2020/07/13 13:38:58 ET]
Table 'McNaught' 9-max Seat #1 is the button
Seat 1: dzhonijs_e ($2.35 in chips) 
Seat 2: alosksora ($3.57 in chips) 
Seat 3: TrankTank ($2 in chips) 
Seat 4: gloommyrat ($2.21 in chips) 
Seat 5: Iron208 ($2.04 in chips) 
Seat 6: qtmm ($2.23 in chips) 
Seat 7: Fostal_by ($2.02 in chips) 
Seat 8: GaliRah ($2.48 in chips) 
Seat 9: jackbam993 ($0.80 in chips) 
alosksora: posts small blind $0.01
TrankTank: posts big blind $0.02
*** HOLE CARDS ***
Dealt to TrankTank [4h 7c]
gloommyrat: folds 
Iron208: folds 
qtmm: folds 
Fostal_by: folds 
GaliRah: raises $0.04 to $0.06
jackbam993: folds 
dzhonijs_e: folds 
alosksora: folds 
TrankTank: folds 
Uncalled bet ($0.04) returned to GaliRah
GaliRah collected $0.05 from pot
*** SUMMARY ***
Total pot $0.05 | Rake $0 
Seat 1: dzhonijs_e (button) folded before Flop (didn't bet)
Seat 2: alosksora (small blind) folded before Flop
Seat 3: TrankTank (big blind) folded before Flop
Seat 4: gloommyrat folded before Flop (didn't bet)
Seat 5: Iron208 folded before Flop (didn't bet)
Seat 6: qtmm folded before Flop (didn't bet)
Seat 7: Fostal_by folded before Flop (didn't bet)
Seat 8: GaliRah collected ($0.05)
Seat 9: jackbam993 folded before Flop (didn't bet)



PokerStars Zoom Hand #216383466434:  Hold'em No Limit ($0.01/$0.02) - 2020/07/13 19:39:26 CET [2020/07/13 13:39:26 ET]
Table 'McNaught' 9-max Seat #1 is the button
Seat 1: TheBlade8525 ($4.35 in chips) 
Seat 2: TrankTank ($2 in chips) 
Seat 3: tomashovka55 ($2 in chips) 
Seat 4: Vulcan615 ($0.32 in chips) 
Seat 5: Mara6111 ($3.43 in chips) 
Seat 6: Dambouski Y ($2 in chips) 
Seat 7: dzhonijs_e ($2.35 in chips) 
Seat 8: HAL VAGYOK ($6.61 in chips) 
Seat 9: BONECA DELICADA ($1.66 in chips) 
TrankTank: posts small blind $0.01
tomashovka55: posts big blind $0.02
*** HOLE CARDS ***
Dealt to TrankTank [Ad Jc]
Vulcan615: folds 
Mara6111: calls $0.02
Dambouski Y: folds 
dzhonijs_e: folds 
HAL VAGYOK: raises $0.07 to $0.09
BONECA DELICADA: folds 
TheBlade8525: folds 
TrankTank: calls $0.08
tomashovka55: folds 
Mara6111: folds 
*** FLOP *** [Td Th 9c]
TrankTank: bets $0.15
HAL VAGYOK: raises $0.15 to $0.30
TrankTank: folds 
Uncalled bet ($0.15) returned to HAL VAGYOK
HAL VAGYOK collected $0.50 from pot
HAL VAGYOK: doesn't show hand 
*** SUMMARY ***
Total pot $0.52 | Rake $0.02 
Board [Td Th 9c]
Seat 1: TheBlade8525 (button) folded before Flop (didn't bet)
Seat 2: TrankTank (small blind) folded on the Flop
Seat 3: tomashovka55 (big blind) folded before Flop
Seat 4: Vulcan615 folded before Flop (didn't bet)
Seat 5: Mara6111 folded before Flop
Seat 6: Dambouski Y folded before Flop (didn't bet)
Seat 7: dzhonijs_e folded before Flop (didn't bet)
Seat 8: HAL VAGYOK collected ($0.50)
Seat 9: BONECA DELICADA folded before Flop (didn't bet)



PokerStars Zoom Hand #216383490740:  Hold'em No Limit ($0.01/$0.02) - 2020/07/13 19:40:10 CET [2020/07/13 13:40:10 ET]
Table 'McNaught' 9-max Seat #1 is the button
Seat 1: Mizepa ($3.45 in chips) 
Seat 2: BerenKamlost ($3.77 in chips) 
Seat 3: CÉZ@R ($0.60 in chips) 
Seat 4: PhilB111 ($2.48 in chips) 
Seat 5: joehlavicka ($2.03 in chips) 
Seat 6: tomashovka55 ($2 in chips) 
Seat 7: pumpedli ($2.76 in chips) 
Seat 8: alosksora ($3.54 in chips) 
Seat 9: TrankTank ($2 in chips) 
BerenKamlost: posts small blind $0.01
CÉZ@R: posts big blind $0.02
*** HOLE CARDS ***
Dealt to TrankTank [9s Jc]
PhilB111 has timed out
PhilB111: folds 
joehlavicka: folds 
tomashovka55: folds 
PhilB111 is disconnected 
pumpedli: folds 
alosksora: folds 
TrankTank: folds 
Mizepa: folds 
BerenKamlost: folds 
Uncalled bet ($0.01) returned to CÉZ@R
CÉZ@R collected $0.02 from pot
CÉZ@R: doesn't show hand 
*** SUMMARY ***
Total pot $0.02 | Rake $0 
Seat 1: Mizepa (button) folded before Flop (didn't bet)
Seat 2: BerenKamlost (small blind) folded before Flop
Seat 3: CÉZ@R (big blind) collected ($0.02)
Seat 4: PhilB111 folded before Flop (didn't bet)
Seat 5: joehlavicka folded before Flop (didn't bet)
Seat 6: tomashovka55 folded before Flop (didn't bet)
Seat 7: pumpedli folded before Flop (didn't bet)
Seat 8: alosksora folded before Flop (didn't bet)
Seat 9: TrankTank folded before Flop (didn't bet)



PokerStars Zoom Hand #216383498913:  Hold'em No Limit ($0.01/$0.02) - 2020/07/13 19:40:25 CET [2020/07/13 13:40:25 ET]
Table 'McNaught' 9-max Seat #1 is the button
Seat 1: BLEF1973 ($7.60 in chips) 
Seat 2: tomashovka55 ($4.29 in chips) 
Seat 3: joehlavicka ($2 in chips) 
Seat 4: hoss145 ($3.36 in chips) 
Seat 5: Dows&Poker ($1.87 in chips) 
Seat 6: Dambouski Y ($4.16 in chips) 
Seat 7: snow9001 ($2.08 in chips) 
Seat 8: TrankTank ($2 in chips) 
Seat 9: PhilB111 ($2.43 in chips) 
tomashovka55: posts small blind $0.01
joehlavicka: posts big blind $0.02
*** HOLE CARDS ***
Dealt to TrankTank [4h Kd]
hoss145: raises $0.02 to $0.04
Dows&Poker: folds 
PhilB111 is disconnected 
Dambouski Y: folds 
snow9001: folds 
TrankTank: folds 
PhilB111: folds 
BLEF1973: folds 
tomashovka55: folds 
joehlavicka: folds 
Uncalled bet ($0.02) returned to hoss145
hoss145 collected $0.05 from pot
hoss145: doesn't show hand 
*** SUMMARY ***
Total pot $0.05 | Rake $0 
Seat 1: BLEF1973 (button) folded before Flop (didn't bet)
Seat 2: tomashovka55 (small blind) folded before Flop
Seat 3: joehlavicka (big blind) folded before Flop
Seat 4: hoss145 collected ($0.05)
Seat 5: Dows&Poker folded before Flop (didn't bet)
Seat 6: Dambouski Y folded before Flop (didn't bet)
Seat 7: snow9001 folded before Flop (didn't bet)
Seat 8: TrankTank folded before Flop (didn't bet)
Seat 9: PhilB111 folded before Flop (didn't bet)



PokerStars Zoom Hand #216383506627:  Hold'em No Limit ($0.01/$0.02) - 2020/07/13 19:40:39 CET [2020/07/13 13:40:39 ET]
Table 'McNaught' 9-max Seat #1 is the button
Seat 1: PhilB111 ($2.48 in chips) 
Seat 2: CÉZ@R ($0.61 in chips) 
Seat 3: STYNG01 ($5.73 in chips) 
Seat 4: Brixx440 ($2.90 in chips) 
Seat 5: Kepas1 ($4.31 in chips) 
Seat 6: TrankTank ($2 in chips) 
Seat 7: BLEF1973 ($7.60 in chips) 
Seat 8: Krimil ($3.36 in chips) 
Seat 9: hurla64 ($4.68 in chips) 
CÉZ@R: posts small blind $0.01
STYNG01: posts big blind $0.02
*** HOLE CARDS ***
Dealt to TrankTank [5d Ks]
Brixx440: folds 
Kepas1: folds 
TrankTank: folds 
BLEF1973: folds 
Krimil: folds 
hurla64: folds 
PhilB111: folds 
CÉZ@R: folds 
Uncalled bet ($0.01) returned to STYNG01
PhilB111 is disconnected 
STYNG01 collected $0.02 from pot
STYNG01: doesn't show hand 
*** SUMMARY ***
Total pot $0.02 | Rake $0 
Seat 1: PhilB111 (button) folded before Flop (didn't bet)
Seat 2: CÉZ@R (small blind) folded before Flop
Seat 3: STYNG01 (big blind) collected ($0.02)
Seat 4: Brixx440 folded before Flop (didn't bet)
Seat 5: Kepas1 folded before Flop (didn't bet)
Seat 6: TrankTank folded before Flop (didn't bet)
Seat 7: BLEF1973 folded before Flop (didn't bet)
Seat 8: Krimil folded before Flop (didn't bet)
Seat 9: hurla64 folded before Flop (didn't bet)



PokerStars Zoom Hand #216383502166:  Hold'em No Limit ($0.01/$0.02) - 2020/07/13 19:40:31 CET [2020/07/13 13:40:31 ET]
Table 'McNaught' 9-max Seat #1 is the button
Seat 1: TrankTank ($2 in chips) 
Seat 2: wraggy225 ($4.76 in chips) 
Seat 3: snow9001 ($2.08 in chips) 
Seat 4: PhilB111 ($2.43 in chips) 
Seat 5: oanhoanh ($2.40 in chips) 
Seat 6: hurla64 ($4.68 in chips) 
Seat 7: Petrovich-95 ($0.81 in chips) 
Seat 8: Aveena2 ($2.03 in chips) 
Seat 9: Mizepa ($3.45 in chips) 
wraggy225: posts small blind $0.01
snow9001: posts big blind $0.02
*** HOLE CARDS ***
Dealt to TrankTank [7s 5h]
PhilB111: folds 
oanhoanh: folds 
hurla64: folds 
PhilB111 is disconnected 
Petrovich-95: folds 
Aveena2: folds 
Mizepa: raises $0.03 to $0.05
TrankTank: folds 
wraggy225: folds 
snow9001: folds 
Uncalled bet ($0.03) returned to Mizepa
Mizepa collected $0.05 from pot
Mizepa: doesn't show hand 
*** SUMMARY ***
Total pot $0.05 | Rake $0 
Seat 1: TrankTank (button) folded before Flop (didn't bet)
Seat 2: wraggy225 (small blind) folded before Flop
Seat 3: snow9001 (big blind) folded before Flop
Seat 4: PhilB111 folded before Flop (didn't bet)
Seat 5: oanhoanh folded before Flop (didn't bet)
Seat 6: hurla64 folded before Flop (didn't bet)
Seat 7: Petrovich-95 folded before Flop (didn't bet)
Seat 8: Aveena2 folded before Flop (didn't bet)
Seat 9: Mizepa collected ($0.05)



PokerStars Zoom Hand #216383512156:  Hold'em No Limit ($0.01/$0.02) - 2020/07/13 19:40:49 CET [2020/07/13 13:40:49 ET]
Table 'McNaught' 9-max Seat #1 is the button
Seat 1: partizan_vlg ($1.06 in chips) 
Seat 2: PhilB111 ($2.24 in chips) 
Seat 3: eNtErStAr ($3.09 in chips) 
Seat 4: sayatsemey ($2.38 in chips) 
Seat 5: Krimil ($3.36 in chips) 
Seat 6: WilFred.ru ($1.89 in chips) 
Seat 7: TrankTank ($2 in chips) 
Seat 8: Elvis ah ha ($2.73 in chips) 
Seat 9: Akiwjuh ($1.80 in chips) 
PhilB111: posts small blind $0.01
eNtErStAr: posts big blind $0.02
*** HOLE CARDS ***
Dealt to TrankTank [Jd 3c]
sayatsemey: raises $0.04 to $0.06
Krimil: folds 
Akiwjuh is disconnected 
PhilB111 is disconnected 
WilFred.ru: folds 
TrankTank: folds 
Elvis ah ha: folds 
Akiwjuh: folds 
partizan_vlg: folds 
PhilB111: folds 
eNtErStAr: folds 
Uncalled bet ($0.04) returned to sayatsemey
sayatsemey collected $0.05 from pot
sayatsemey: doesn't show hand 
*** SUMMARY ***
Total pot $0.05 | Rake $0 
Seat 1: partizan_vlg (button) folded before Flop (didn't bet)
Seat 2: PhilB111 (small blind) folded before Flop
Seat 3: eNtErStAr (big blind) folded before Flop
Seat 4: sayatsemey collected ($0.05)
Seat 5: Krimil folded before Flop (didn't bet)
Seat 6: WilFred.ru folded before Flop (didn't bet)
Seat 7: TrankTank folded before Flop (didn't bet)
Seat 8: Elvis ah ha folded before Flop (didn't bet)
Seat 9: Akiwjuh folded before Flop (didn't bet)



PokerStars Zoom Hand #216383517065:  Hold'em No Limit ($0.01/$0.02) - 2020/07/13 19:40:58 CET [2020/07/13 13:40:58 ET]
Table 'McNaught' 9-max Seat #1 is the button
Seat 1: wraggy225 ($4.73 in chips) 
Seat 2: bugsbunnies ($0.61 in chips) 
Seat 3: TrankTank ($2 in chips) 
Seat 4: AdaiRu888 ($2 in chips) 
Seat 5: bogdan_k_ua ($2.95 in chips) 
Seat 6: luda555 ($1.45 in chips) 
Seat 7: hurla64 ($9.77 in chips) 
Seat 8: snow9001 ($2.06 in chips) 
Seat 9: Dambouski Y ($2 in chips) 
bugsbunnies: posts small blind $0.01
TrankTank: posts big blind $0.02
*** HOLE CARDS ***
Dealt to TrankTank [7c 8d]
AdaiRu888: folds 
bogdan_k_ua: folds 
luda555: folds 
hurla64: raises $0.04 to $0.06
snow9001: folds 
Dambouski Y: folds 
wraggy225: folds 
bugsbunnies: folds 
TrankTank: folds 
Uncalled bet ($0.04) returned to hurla64
hurla64 collected $0.05 from pot
hurla64: doesn't show hand 
*** SUMMARY ***
Total pot $0.05 | Rake $0 
Seat 1: wraggy225 (button) folded before Flop (didn't bet)
Seat 2: bugsbunnies (small blind) folded before Flop
Seat 3: TrankTank (big blind) folded before Flop
Seat 4: AdaiRu888 folded before Flop (didn't bet)
Seat 5: bogdan_k_ua folded before Flop (didn't bet)
Seat 6: luda555 folded before Flop (didn't bet)
Seat 7: hurla64 collected ($0.05)
Seat 8: snow9001 folded before Flop (didn't bet)
Seat 9: Dambouski Y folded before Flop (didn't bet)



PokerStars Zoom Hand #216383514402:  Hold'em No Limit ($0.01/$0.02) - 2020/07/13 19:40:53 CET [2020/07/13 13:40:53 ET]
Table 'McNaught' 9-max Seat #1 is the button
Seat 1: joehlavicka ($1.97 in chips) 
Seat 2: BerenKamlost ($3.76 in chips) 
Seat 3: Fostal_by ($2.03 in chips) 
Seat 4: TrankTank ($2 in chips) 
Seat 5: papatomi4 ($2.15 in chips) 
Seat 6: snow9001 ($2.81 in chips) 
Seat 7: pumpedli ($2 in chips) 
Seat 8: stiefidi ($1.60 in chips) 
Seat 9: Trainerst ($2.35 in chips) 
BerenKamlost: posts small blind $0.01
Fostal_by: posts big blind $0.02
*** HOLE CARDS ***
Dealt to TrankTank [4c 2c]
TrankTank: folds 
papatomi4: folds 
snow9001: folds 
pumpedli: folds 
stiefidi: raises $0.02 to $0.04
Trainerst: calls $0.04
joehlavicka: folds 
BerenKamlost: folds 
Fostal_by: folds 
*** FLOP *** [9s 3s Ts]
stiefidi: bets $0.04
Trainerst: calls $0.04
*** TURN *** [9s 3s Ts] [4d]
stiefidi: bets $0.04
Trainerst: calls $0.04
*** RIVER *** [9s 3s Ts 4d] [7c]
stiefidi: checks 
Trainerst: bets $0.12
stiefidi: calls $0.12
*** SHOW DOWN ***
Trainerst: shows [Js 8d] (a straight, Seven to Jack)
stiefidi: mucks hand 
Trainerst collected $0.49 from pot
*** SUMMARY ***
Total pot $0.51 | Rake $0.02 
Board [9s 3s Ts 4d 7c]
Seat 1: joehlavicka (button) folded before Flop (didn't bet)
Seat 2: BerenKamlost (small blind) folded before Flop
Seat 3: Fostal_by (big blind) folded before Flop
Seat 4: TrankTank folded before Flop (didn't bet)
Seat 5: papatomi4 folded before Flop (didn't bet)
Seat 6: snow9001 folded before Flop (didn't bet)
Seat 7: pumpedli folded before Flop (didn't bet)
Seat 8: stiefidi mucked [Qc Tc]
Seat 9: Trainerst showed [Js 8d] and won ($0.49) with a straight, Seven to Jack



PokerStars Zoom Hand #216383525333:  Hold'em No Limit ($0.01/$0.02) - 2020/07/13 19:41:13 CET [2020/07/13 13:41:13 ET]
Table 'McNaught' 9-max Seat #1 is the button
Seat 1: J0SHB0SH ($2.11 in chips) 
Seat 2: BONECA DELICADA ($1.87 in chips) 
Seat 3: Mizepa ($3.86 in chips) 
Seat 4: alosksora ($3.52 in chips) 
Seat 5: FelixFerrari ($1.07 in chips) 
Seat 6: 21041956 ($1.42 in chips) 
Seat 7: Dambouski Y ($2 in chips) 
Seat 8: Kepas1 ($4.31 in chips) 
Seat 9: TrankTank ($2 in chips) 
BONECA DELICADA: posts small blind $0.01
Mizepa: posts big blind $0.02
*** HOLE CARDS ***
Dealt to TrankTank [8d 8s]
alosksora: raises $0.03 to $0.05
FelixFerrari: folds 
21041956: folds 
Dambouski Y: folds 
Kepas1: folds 
TrankTank: calls $0.05
J0SHB0SH: folds 
BONECA DELICADA: folds 
Mizepa: folds 
*** FLOP *** [Qc Qh 9s]
alosksora: bets $0.02
TrankTank: calls $0.02
*** TURN *** [Qc Qh 9s] [8h]
alosksora: bets $0.08
TrankTank: calls $0.08
*** RIVER *** [Qc Qh 9s 8h] [4s]
alosksora: bets $3.37 and is all-in
TrankTank: calls $1.85 and is all-in
Uncalled bet ($1.52) returned to alosksora
*** SHOW DOWN ***
alosksora: shows [As Qs] (three of a kind, Queens)
TrankTank: shows [8d 8s] (a full house, Eights full of Queens)
TrankTank collected $3.89 from pot
*** SUMMARY ***
Total pot $4.03 | Rake $0.14 
Board [Qc Qh 9s 8h 4s]
Seat 1: J0SHB0SH (button) folded before Flop (didn't bet)
Seat 2: BONECA DELICADA (small blind) folded before Flop
Seat 3: Mizepa (big blind) folded before Flop
Seat 4: alosksora showed [As Qs] and lost with three of a kind, Queens
Seat 5: FelixFerrari folded before Flop (didn't bet)
Seat 6: 21041956 folded before Flop (didn't bet)
Seat 7: Dambouski Y folded before Flop (didn't bet)
Seat 8: Kepas1 folded before Flop (didn't bet)
Seat 9: TrankTank showed [8d 8s] and won ($3.89) with a full house, Eights full of Queens



PokerStars Zoom Hand #216383569314:  Hold'em No Limit ($0.01/$0.02) - 2020/07/13 19:42:32 CET [2020/07/13 13:42:32 ET]
Table 'McNaught' 9-max Seat #1 is the button
Seat 1: birarema ($3.42 in chips) 
Seat 2: River_GmbH ($1.33 in chips) 
Seat 3: pumpedli ($2.72 in chips) 
Seat 4: Kepas1 ($4.31 in chips) 
Seat 5: TrankTank ($3.89 in chips) 
Seat 6: Thisisnotme712 ($2 in chips) 
Seat 7: AdaiRu888 ($2 in chips) 
Seat 8: wraggy225 ($3.98 in chips) 
Seat 9: Petrovich-95 ($0.77 in chips) 
River_GmbH: posts small blind $0.01
pumpedli: posts big blind $0.02
*** HOLE CARDS ***
Dealt to TrankTank [Qc Qs]
Kepas1: folds 
TrankTank: raises $0.04 to $0.06
Thisisnotme712: folds 
AdaiRu888: folds 
wraggy225: folds 
Petrovich-95: folds 
birarema: folds 
River_GmbH: folds 
pumpedli: folds 
Uncalled bet ($0.04) returned to TrankTank
TrankTank collected $0.05 from pot
TrankTank: doesn't show hand 
*** SUMMARY ***
Total pot $0.05 | Rake $0 
Seat 1: birarema (button) folded before Flop (didn't bet)
Seat 2: River_GmbH (small blind) folded before Flop
Seat 3: pumpedli (big blind) folded before Flop
Seat 4: Kepas1 folded before Flop (didn't bet)
Seat 5: TrankTank collected ($0.05)
Seat 6: Thisisnotme712 folded before Flop (didn't bet)
Seat 7: AdaiRu888 folded before Flop (didn't bet)
Seat 8: wraggy225 folded before Flop (didn't bet)
Seat 9: Petrovich-95 folded before Flop (didn't bet)



PokerStars Zoom Hand #216383584779:  Hold'em No Limit ($0.01/$0.02) - 2020/07/13 19:43:00 CET [2020/07/13 13:43:00 ET]
Table 'McNaught' 9-max Seat #1 is the button
Seat 1: Tiggu ($1.93 in chips) 
Seat 2: TrankTank ($3.92 in chips) 
Seat 3: canxuh ($2.04 in chips) 
Seat 4: dzhonijs_e ($2.57 in chips) 
Seat 5: partizan_vlg ($1.62 in chips) 
Seat 6: Krimil ($3.35 in chips) 
Seat 7: Aveena2 ($2.02 in chips) 
Seat 8: ggGoldenPunk ($4.24 in chips) 
Seat 9: FelixFerrari ($1.08 in chips) 
TrankTank: posts small blind $0.01
canxuh: posts big blind $0.02
*** HOLE CARDS ***
Dealt to TrankTank [2h Tc]
dzhonijs_e: raises $0.04 to $0.06
partizan_vlg: calls $0.06
Krimil: folds 
Aveena2: folds 
ggGoldenPunk: folds 
FelixFerrari: folds 
Tiggu: folds 
TrankTank: folds 
canxuh: folds 
*** FLOP *** [4d 7d 5h]
dzhonijs_e: bets $0.11
partizan_vlg: calls $0.11
*** TURN *** [4d 7d 5h] [4c]
dzhonijs_e: checks 
partizan_vlg: bets $0.14
dzhonijs_e: folds 
Uncalled bet ($0.14) returned to partizan_vlg
partizan_vlg collected $0.36 from pot
partizan_vlg: doesn't show hand 
*** SUMMARY ***
Total pot $0.37 | Rake $0.01 
Board [4d 7d 5h 4c]
Seat 1: Tiggu (button) folded before Flop (didn't bet)
Seat 2: TrankTank (small blind) folded before Flop
Seat 3: canxuh (big blind) folded before Flop
Seat 4: dzhonijs_e folded on the Turn
Seat 5: partizan_vlg collected ($0.36)
Seat 6: Krimil folded before Flop (didn't bet)
Seat 7: Aveena2 folded before Flop (didn't bet)
Seat 8: ggGoldenPunk folded before Flop (didn't bet)
Seat 9: FelixFerrari folded before Flop (didn't bet)



PokerStars Zoom Hand #216383597401:  Hold'em No Limit ($0.01/$0.02) - 2020/07/13 19:43:23 CET [2020/07/13 13:43:23 ET]
Table 'McNaught' 9-max Seat #1 is the button
Seat 1: TrankTank ($3.91 in chips) 
Seat 2: vasyara26 ($0.94 in chips) 
Seat 3: Iron208 ($2.26 in chips) 
Seat 4: joehlavicka ($1.96 in chips) 
Seat 5: pisqnek ($6.40 in chips) 
Seat 6: Brixx440 ($3.21 in chips) 
Seat 7: AdaiRu888 ($2 in chips) 
Seat 8: Akiwjuh ($1.77 in chips) 
Seat 9: Marmelicious ($1.70 in chips) 
vasyara26: posts small blind $0.01
Iron208: posts big blind $0.02
*** HOLE CARDS ***
Dealt to TrankTank [Qh Qd]
joehlavicka: folds 
pisqnek: folds 
Brixx440: folds 
Akiwjuh is disconnected 
AdaiRu888: calls $0.02
Akiwjuh: folds 
Marmelicious: folds 
TrankTank: raises $0.05 to $0.07
vasyara26: folds 
Iron208: folds 
AdaiRu888: calls $0.05
*** FLOP *** [Kh 3d Th]
AdaiRu888: checks 
TrankTank: bets $0.11
AdaiRu888: folds 
Uncalled bet ($0.11) returned to TrankTank
TrankTank collected $0.16 from pot
TrankTank: doesn't show hand 
*** SUMMARY ***
Total pot $0.17 | Rake $0.01 
Board [Kh 3d Th]
Seat 1: TrankTank (button) collected ($0.16)
Seat 2: vasyara26 (small blind) folded before Flop
Seat 3: Iron208 (big blind) folded before Flop
Seat 4: joehlavicka folded before Flop (didn't bet)
Seat 5: pisqnek folded before Flop (didn't bet)
Seat 6: Brixx440 folded before Flop (didn't bet)
Seat 7: AdaiRu888 folded on the Flop
Seat 8: Akiwjuh folded before Flop (didn't bet)
Seat 9: Marmelicious folded before Flop (didn't bet)



PokerStars Zoom Hand #216383592475:  Hold'em No Limit ($0.01/$0.02) - 2020/07/13 19:43:14 CET [2020/07/13 13:43:14 ET]
Table 'McNaught' 9-max Seat #1 is the button
Seat 1: STYNG01 ($17.38 in chips) 
Seat 2: gloommyrat ($2.50 in chips) 
Seat 3: hoss145 ($3.50 in chips) 
Seat 4: murrie666 ($2 in chips) 
Seat 5: Aveena2 ($2.02 in chips) 
Seat 6: J0SHB0SH ($2.40 in chips) 
Seat 7: Iron208 ($2.26 in chips) 
Seat 8: TrankTank ($3.91 in chips) 
Seat 9: Mizepa ($3.76 in chips) 
gloommyrat: posts small blind $0.01
hoss145: posts big blind $0.02
*** HOLE CARDS ***
Dealt to TrankTank [Jh 2c]
murrie666: folds 
Aveena2: folds 
J0SHB0SH: folds 
Iron208: folds 
TrankTank: folds 
Mizepa: raises $0.03 to $0.05
STYNG01: calls $0.05
gloommyrat: calls $0.04
hoss145: folds 
*** FLOP *** [7d 3s 3d]
gloommyrat: checks 
Mizepa: checks 
STYNG01: bets $0.08
gloommyrat: folds 
Mizepa: calls $0.08
*** TURN *** [7d 3s 3d] [7h]
Mizepa: checks 
STYNG01: checks 
*** RIVER *** [7d 3s 3d 7h] [9h]
Mizepa: checks 
STYNG01: bets $0.16
Mizepa: folds 
Uncalled bet ($0.16) returned to STYNG01
STYNG01 collected $0.32 from pot
STYNG01: doesn't show hand 
*** SUMMARY ***
Total pot $0.33 | Rake $0.01 
Board [7d 3s 3d 7h 9h]
Seat 1: STYNG01 (button) collected ($0.32)
Seat 2: gloommyrat (small blind) folded on the Flop
Seat 3: hoss145 (big blind) folded before Flop
Seat 4: murrie666 folded before Flop (didn't bet)
Seat 5: Aveena2 folded before Flop (didn't bet)
Seat 6: J0SHB0SH folded before Flop (didn't bet)
Seat 7: Iron208 folded before Flop (didn't bet)
Seat 8: TrankTank folded before Flop (didn't bet)
Seat 9: Mizepa folded on the River



PokerStars Zoom Hand #216383621369:  Hold'em No Limit ($0.01/$0.02) - 2020/07/13 19:44:06 CET [2020/07/13 13:44:06 ET]
Table 'McNaught' 9-max Seat #1 is the button
Seat 1: ggGoldenPunk ($2.10 in chips) 
Seat 2: jonick17 ($1.36 in chips) 
Seat 3: Diva_E36 ($1.62 in chips) 
Seat 4: hoss145 ($2.06 in chips) 
Seat 5: cuzmich500 ($1.19 in chips) 
Seat 6: Rummy41 ($3.26 in chips) 
Seat 7: TrankTank ($4 in chips) 
Seat 8: PhilB111 ($2.83 in chips) 
Seat 9: niko16321 ($1.72 in chips) 
jonick17: posts small blind $0.01
Diva_E36: posts big blind $0.02
*** HOLE CARDS ***
Dealt to TrankTank [As 5c]
hoss145: folds 
cuzmich500: folds 
Rummy41: folds 
TrankTank: folds 
PhilB111: folds 
niko16321: folds 
ggGoldenPunk: folds 
PhilB111 is disconnected 
jonick17: calls $0.01
Diva_E36: checks 
*** FLOP *** [7d Td Ad]
jonick17: checks 
Diva_E36: checks 
*** TURN *** [7d Td Ad] [8s]
jonick17: checks 
Diva_E36: bets $0.02
jonick17: folds 
Uncalled bet ($0.02) returned to Diva_E36
Diva_E36 collected $0.04 from pot
Diva_E36: doesn't show hand 
*** SUMMARY ***
Total pot $0.04 | Rake $0 
Board [7d Td Ad 8s]
Seat 1: ggGoldenPunk (button) folded before Flop (didn't bet)
Seat 2: jonick17 (small blind) folded on the Turn
Seat 3: Diva_E36 (big blind) collected ($0.04)
Seat 4: hoss145 folded before Flop (didn't bet)
Seat 5: cuzmich500 folded before Flop (didn't bet)
Seat 6: Rummy41 folded before Flop (didn't bet)
Seat 7: TrankTank folded before Flop (didn't bet)
Seat 8: PhilB111 folded before Flop (didn't bet)
Seat 9: niko16321 folded before Flop (didn't bet)



PokerStars Zoom Hand #216383638584:  Hold'em No Limit ($0.01/$0.02) - 2020/07/13 19:44:37 CET [2020/07/13 13:44:37 ET]
Table 'McNaught' 9-max Seat #1 is the button
Seat 1: eNtErStAr ($3.91 in chips) 
Seat 2: J0SHB0SH ($2 in chips) 
Seat 3: TrankTank ($4 in chips) 
Seat 4: Fostal_by ($2 in chips) 
Seat 5: pumpedli ($2.74 in chips) 
Seat 6: bobbwfc26 ($1.85 in chips) 
Seat 7: hurla64 ($11.50 in chips) 
Seat 8: SUPERNUNO ($2.01 in chips) 
Seat 9: partizan_vlg ($1.78 in chips) 
J0SHB0SH: posts small blind $0.01
TrankTank: posts big blind $0.02
*** HOLE CARDS ***
Dealt to TrankTank [3s As]
Fostal_by: folds 
pumpedli: folds 
bobbwfc26: folds 
hurla64: folds 
SUPERNUNO: calls $0.02
partizan_vlg: folds 
eNtErStAr: folds 
J0SHB0SH: folds 
TrankTank: checks 
*** FLOP *** [3h 2c 4s]
TrankTank: bets $0.04
SUPERNUNO: folds 
Uncalled bet ($0.04) returned to TrankTank
TrankTank collected $0.05 from pot
TrankTank: doesn't show hand 
*** SUMMARY ***
Total pot $0.05 | Rake $0 
Board [3h 2c 4s]
Seat 1: eNtErStAr (button) folded before Flop (didn't bet)
Seat 2: J0SHB0SH (small blind) folded before Flop
Seat 3: TrankTank (big blind) collected ($0.05)
Seat 4: Fostal_by folded before Flop (didn't bet)
Seat 5: pumpedli folded before Flop (didn't bet)
Seat 6: bobbwfc26 folded before Flop (didn't bet)
Seat 7: hurla64 folded before Flop (didn't bet)
Seat 8: SUPERNUNO folded on the Flop
Seat 9: partizan_vlg folded before Flop (didn't bet)



PokerStars Zoom Hand #216383633535:  Hold'em No Limit ($0.01/$0.02) - 2020/07/13 19:44:28 CET [2020/07/13 13:44:28 ET]
Table 'McNaught' 9-max Seat #1 is the button
Seat 1: RyuInShadow ($1.98 in chips) 
Seat 2: Pentonomix ($3.10 in chips) 
Seat 3: BRENOMACHADO ($1.14 in chips) 
Seat 4: TrankTank ($4 in chips) 
Seat 5: pisqnek ($6.37 in chips) 
Seat 6: joehlavicka ($2.21 in chips) 
Seat 7: qtmm ($2.17 in chips) 
Seat 8: STYNG01 ($6.25 in chips) 
Seat 9: CÉZ@R ($0.31 in chips) 
Pentonomix: posts small blind $0.01
BRENOMACHADO: posts big blind $0.02
*** HOLE CARDS ***
Dealt to TrankTank [As 2c]
TrankTank: folds 
pisqnek: raises $0.05 to $0.07
joehlavicka: folds 
qtmm: folds 
STYNG01: folds 
CÉZ@R: raises $0.24 to $0.31 and is all-in
RyuInShadow: folds 
Pentonomix: folds 
BRENOMACHADO: folds 
pisqnek: calls $0.24
*** FLOP *** [Qs 4d 5h]
*** TURN *** [Qs 4d 5h] [Qh]
*** RIVER *** [Qs 4d 5h Qh] [7d]
*** SHOW DOWN ***
pisqnek: shows [Kh Kc] (two pair, Kings and Queens)
CÉZ@R: shows [9h Ad] (a pair of Queens)
pisqnek collected $0.63 from pot
*** SUMMARY ***
Total pot $0.65 | Rake $0.02 
Board [Qs 4d 5h Qh 7d]
Seat 1: RyuInShadow (button) folded before Flop (didn't bet)
Seat 2: Pentonomix (small blind) folded before Flop
Seat 3: BRENOMACHADO (big blind) folded before Flop
Seat 4: TrankTank folded before Flop (didn't bet)
Seat 5: pisqnek showed [Kh Kc] and won ($0.63) with two pair, Kings and Queens
Seat 6: joehlavicka folded before Flop (didn't bet)
Seat 7: qtmm folded before Flop (didn't bet)
Seat 8: STYNG01 folded before Flop (didn't bet)
Seat 9: CÉZ@R showed [9h Ad] and lost with a pair of Queens



PokerStars Zoom Hand #216383627516:  Hold'em No Limit ($0.01/$0.02) - 2020/07/13 19:44:17 CET [2020/07/13 13:44:17 ET]
Table 'McNaught' 9-max Seat #1 is the button
Seat 1: igor761022 ($0.97 in chips) 
Seat 2: IziPizi91 ($1.01 in chips) 
Seat 3: partizan_vlg ($0.91 in chips) 
Seat 4: BONECA DELICADA ($1.72 in chips) 
Seat 5: FelixFerrari ($1.03 in chips) 
Seat 6: TrankTank ($4 in chips) 
Seat 7: gloommyrat ($7.36 in chips) 
Seat 8: jackbam993 ($0.87 in chips) 
Seat 9: STYNG01 ($17.57 in chips) 
IziPizi91: posts small blind $0.01
partizan_vlg: posts big blind $0.02
*** HOLE CARDS ***
Dealt to TrankTank [7h 5c]
BONECA DELICADA: folds 
FelixFerrari: folds 
TrankTank: folds 
gloommyrat: folds 
jackbam993: folds 
STYNG01: raises $0.02 to $0.04
igor761022: folds 
IziPizi91: calls $0.03
partizan_vlg: folds 
*** FLOP *** [7s Th Ah]
IziPizi91: checks 
STYNG01: bets $0.05
IziPizi91: raises $0.05 to $0.10
STYNG01: calls $0.05
*** TURN *** [7s Th Ah] [4c]
IziPizi91: checks 
STYNG01: checks 
*** RIVER *** [7s Th Ah 4c] [Jh]
IziPizi91: bets $0.10
STYNG01: folds 
Uncalled bet ($0.10) returned to IziPizi91
IziPizi91 collected $0.29 from pot
IziPizi91: doesn't show hand 
*** SUMMARY ***
Total pot $0.30 | Rake $0.01 
Board [7s Th Ah 4c Jh]
Seat 1: igor761022 (button) folded before Flop (didn't bet)
Seat 2: IziPizi91 (small blind) collected ($0.29)
Seat 3: partizan_vlg (big blind) folded before Flop
Seat 4: BONECA DELICADA folded before Flop (didn't bet)
Seat 5: FelixFerrari folded before Flop (didn't bet)
Seat 6: TrankTank folded before Flop (didn't bet)
Seat 7: gloommyrat folded before Flop (didn't bet)
Seat 8: jackbam993 folded before Flop (didn't bet)
Seat 9: STYNG01 folded on the River



PokerStars Zoom Hand #216383651735:  Hold'em No Limit ($0.01/$0.02) - 2020/07/13 19:45:01 CET [2020/07/13 13:45:01 ET]
Table 'McNaught' 9-max Seat #1 is the button
Seat 1: Akiwjuh ($0.90 in chips) 
Seat 2: Mara6111 ($3.48 in chips) 
Seat 3: BerenKamlost ($3.16 in chips) 
Seat 4: XHerrTUMNUSX ($2.02 in chips) 
Seat 5: bugsbunnies ($0.71 in chips) 
Seat 6: TrankTank ($4.03 in chips) 
Seat 7: pumpedli ($3.92 in chips) 
Seat 8: joehlavicka ($1.93 in chips) 
Seat 9: Marmelicious ($1.62 in chips) 
Mara6111: posts small blind $0.01
BerenKamlost: posts big blind $0.02
*** HOLE CARDS ***
Dealt to TrankTank [2d Jh]
XHerrTUMNUSX: folds 
Akiwjuh is disconnected 
bugsbunnies: raises $0.02 to $0.04
TrankTank: folds 
pumpedli: folds 
joehlavicka: folds 
Marmelicious: folds 
Akiwjuh: folds 
Mara6111: calls $0.03
BerenKamlost: folds 
*** FLOP *** [Ah 9h 6s]
Mara6111: bets $0.08
bugsbunnies: folds 
Uncalled bet ($0.08) returned to Mara6111
Mara6111 collected $0.10 from pot
Mara6111: doesn't show hand 
*** SUMMARY ***
Total pot $0.10 | Rake $0 
Board [Ah 9h 6s]
Seat 1: Akiwjuh (button) folded before Flop (didn't bet)
Seat 2: Mara6111 (small blind) collected ($0.10)
Seat 3: BerenKamlost (big blind) folded before Flop
Seat 4: XHerrTUMNUSX folded before Flop (didn't bet)
Seat 5: bugsbunnies folded on the Flop
Seat 6: TrankTank folded before Flop (didn't bet)
Seat 7: pumpedli folded before Flop (didn't bet)
Seat 8: joehlavicka folded before Flop (didn't bet)
Seat 9: Marmelicious folded before Flop (didn't bet)



PokerStars Zoom Hand #216383656204:  Hold'em No Limit ($0.01/$0.02) - 2020/07/13 19:45:09 CET [2020/07/13 13:45:09 ET]
Table 'McNaught' 9-max Seat #1 is the button
Seat 1: PhilB111 ($2.27 in chips) 
Seat 2: TrankTank ($4.03 in chips) 
Seat 3: patkosmpa ($1.51 in chips) 
Seat 4: pisqnek ($6.69 in chips) 
Seat 5: BRENOMACHADO ($1.11 in chips) 
Seat 6: gloommyrat ($2.41 in chips) 
Seat 7: hurla64 ($2.03 in chips) 
Seat 8: J0SHB0SH ($2.23 in chips) 
Seat 9: Climax82 ($1.28 in chips) 
TrankTank: posts small blind $0.01
patkosmpa: posts big blind $0.02
*** HOLE CARDS ***
Dealt to TrankTank [5d 6c]
pisqnek: folds 
BRENOMACHADO: folds 
gloommyrat: folds 
hurla64: folds 
J0SHB0SH: raises $0.04 to $0.06
Climax82: folds 
PhilB111: folds 
PhilB111 is disconnected 
TrankTank: folds 
patkosmpa: folds 
Uncalled bet ($0.04) returned to J0SHB0SH
J0SHB0SH collected $0.05 from pot
J0SHB0SH: doesn't show hand 
*** SUMMARY ***
Total pot $0.05 | Rake $0 
Seat 1: PhilB111 (button) folded before Flop (didn't bet)
Seat 2: TrankTank (small blind) folded before Flop
Seat 3: patkosmpa (big blind) folded before Flop
Seat 4: pisqnek folded before Flop (didn't bet)
Seat 5: BRENOMACHADO folded before Flop (didn't bet)
Seat 6: gloommyrat folded before Flop (didn't bet)
Seat 7: hurla64 folded before Flop (didn't bet)
Seat 8: J0SHB0SH collected ($0.05)
Seat 9: Climax82 folded before Flop (didn't bet)



PokerStars Zoom Hand #216383669548:  Hold'em No Limit ($0.01/$0.02) - 2020/07/13 19:45:33 CET [2020/07/13 13:45:33 ET]
Table 'McNaught' 9-max Seat #1 is the button
Seat 1: luda555 ($1.25 in chips) 
Seat 2: River_GmbH ($1.33 in chips) 
Seat 3: Luisk2293 ($2 in chips) 
Seat 4: pellion ($2 in chips) 
Seat 5: Akiwjuh ($0.90 in chips) 
Seat 6: hurla64 ($2 in chips) 
Seat 7: dorro61966 ($3.01 in chips) 
Seat 8: bugsbunnies ($0.67 in chips) 
Seat 9: TrankTank ($4.02 in chips) 
River_GmbH: posts small blind $0.01
Luisk2293: posts big blind $0.02
*** HOLE CARDS ***
Dealt to TrankTank [Ad Qc]
pellion: raises $0.06 to $0.08
Akiwjuh: raises $0.08 to $0.16
hurla64: folds 
dorro61966: folds 
bugsbunnies: raises $0.51 to $0.67 and is all-in
TrankTank: folds 
luda555: folds 
River_GmbH: folds 
Luisk2293: folds 
pellion: folds 
Akiwjuh: calls $0.51
*** FLOP *** [6h 4d 2c]
*** TURN *** [6h 4d 2c] [Qh]
*** RIVER *** [6h 4d 2c Qh] [3h]
*** SHOW DOWN ***
Akiwjuh: shows [Ah Qs] (a pair of Queens)
bugsbunnies: shows [Ac Kh] (high card Ace)
Akiwjuh cashed out the hand for $0.37
*** SUMMARY ***
Total pot $1.45 | Rake $0.05 
Board [6h 4d 2c Qh 3h]
Seat 1: luda555 (button) folded before Flop (didn't bet)
Seat 2: River_GmbH (small blind) folded before Flop
Seat 3: Luisk2293 (big blind) folded before Flop
Seat 4: pellion folded before Flop
Seat 5: Akiwjuh showed [Ah Qs] and won ($1.40) with a pair of Queens (pot not awarded as player cashed out)
Seat 6: hurla64 folded before Flop (didn't bet)
Seat 7: dorro61966 folded before Flop (didn't bet)
Seat 8: bugsbunnies showed [Ac Kh] and lost with high card Ace
Seat 9: TrankTank folded before Flop (didn't bet)



PokerStars Zoom Hand #216383677430:  Hold'em No Limit ($0.01/$0.02) - 2020/07/13 19:45:47 CET [2020/07/13 13:45:47 ET]
Table 'McNaught' 9-max Seat #1 is the button
Seat 1: J0SHB0SH ($2 in chips) 
Seat 2: PhilB111 ($2.45 in chips) 
Seat 3: Tiggu ($1.96 in chips) 
Seat 4: oanhoanh ($2.41 in chips) 
Seat 5: TrankTank ($4.02 in chips) 
Seat 6: pumpedli ($3.53 in chips) 
Seat 7: Thisisnotme712 ($2.14 in chips) 
Seat 8: papatomi4 ($2.39 in chips) 
Seat 9: STYNG01 ($3.03 in chips) 
PhilB111: posts small blind $0.01
Tiggu: posts big blind $0.02
*** HOLE CARDS ***
Dealt to TrankTank [Ah 2s]
oanhoanh: folds 
TrankTank: folds 
pumpedli: raises $0.04 to $0.06
PhilB111 is disconnected 
Thisisnotme712: raises $0.24 to $0.30
papatomi4: folds 
STYNG01: folds 
J0SHB0SH: folds 
PhilB111: folds 
Tiggu: folds 
pumpedli: folds 
Uncalled bet ($0.24) returned to Thisisnotme712
Thisisnotme712 collected $0.15 from pot
Thisisnotme712: doesn't show hand 
*** SUMMARY ***
Total pot $0.15 | Rake $0 
Seat 1: J0SHB0SH (button) folded before Flop (didn't bet)
Seat 2: PhilB111 (small blind) folded before Flop
Seat 3: Tiggu (big blind) folded before Flop
Seat 4: oanhoanh folded before Flop (didn't bet)
Seat 5: TrankTank folded before Flop (didn't bet)
Seat 6: pumpedli folded before Flop
Seat 7: Thisisnotme712 collected ($0.15)
Seat 8: papatomi4 folded before Flop (didn't bet)
Seat 9: STYNG01 folded before Flop (didn't bet)



PokerStars Zoom Hand #216383681268:  Hold'em No Limit ($0.01/$0.02) - 2020/07/13 19:45:54 CET [2020/07/13 13:45:54 ET]
Table 'McNaught' 9-max Seat #1 is the button
Seat 1: TrankTank ($4.02 in chips) 
Seat 2: patkosmpa ($1.49 in chips) 
Seat 3: snow9001 ($2 in chips) 
Seat 4: igor761022 ($0.92 in chips) 
Seat 5: Mara6111 ($3.54 in chips) 
Seat 6: AdaiRu888 ($2.05 in chips) 
Seat 7: papatomi4 ($2.39 in chips) 
Seat 8: hurla64 ($2 in chips) 
Seat 9: Kepas1 ($3.12 in chips) 
patkosmpa: posts small blind $0.01
snow9001: posts big blind $0.02
*** HOLE CARDS ***
Dealt to TrankTank [3s Qd]
igor761022: folds 
Mara6111: folds 
AdaiRu888: folds 
papatomi4: folds 
hurla64: folds 
Kepas1: raises $0.05 to $0.07
TrankTank: folds 
patkosmpa: folds 
snow9001: folds 
Uncalled bet ($0.05) returned to Kepas1
Kepas1 collected $0.05 from pot
Kepas1: doesn't show hand 
*** SUMMARY ***
Total pot $0.05 | Rake $0 
Seat 1: TrankTank (button) folded before Flop (didn't bet)
Seat 2: patkosmpa (small blind) folded before Flop
Seat 3: snow9001 (big blind) folded before Flop
Seat 4: igor761022 folded before Flop (didn't bet)
Seat 5: Mara6111 folded before Flop (didn't bet)
Seat 6: AdaiRu888 folded before Flop (didn't bet)
Seat 7: papatomi4 folded before Flop (didn't bet)
Seat 8: hurla64 folded before Flop (didn't bet)
Seat 9: Kepas1 collected ($0.05)



PokerStars Zoom Hand #216383695838:  Hold'em No Limit ($0.01/$0.02) - 2020/07/13 19:46:20 CET [2020/07/13 13:46:20 ET]
Table 'McNaught' 9-max Seat #1 is the button
Seat 1: J0SHB0SH ($2.25 in chips) 
Seat 2: qtmm ($2.10 in chips) 
Seat 3: weiting777 ($2.32 in chips) 
Seat 4: FelixFerrari ($1.41 in chips) 
Seat 5: wraggy225 ($5.98 in chips) 
Seat 6: jackbam993 ($0.87 in chips) 
Seat 7: TrankTank ($4.02 in chips) 
Seat 8: dzhonijs_e ($2.30 in chips) 
Seat 9: Elvis ah ha ($2.66 in chips) 
qtmm: posts small blind $0.01
weiting777: posts big blind $0.02
*** HOLE CARDS ***
Dealt to TrankTank [Tc 6c]
FelixFerrari: folds 
wraggy225: folds 
jackbam993: folds 
TrankTank: folds 
dzhonijs_e: folds 
Elvis ah ha: folds 
J0SHB0SH: folds 
qtmm: calls $0.01
weiting777: checks 
*** FLOP *** [6s 3h Qc]
qtmm: checks 
weiting777: bets $0.04
qtmm: folds 
Uncalled bet ($0.04) returned to weiting777
weiting777 collected $0.04 from pot
weiting777: doesn't show hand 
*** SUMMARY ***
Total pot $0.04 | Rake $0 
Board [6s 3h Qc]
Seat 1: J0SHB0SH (button) folded before Flop (didn't bet)
Seat 2: qtmm (small blind) folded on the Flop
Seat 3: weiting777 (big blind) collected ($0.04)
Seat 4: FelixFerrari folded before Flop (didn't bet)
Seat 5: wraggy225 folded before Flop (didn't bet)
Seat 6: jackbam993 folded before Flop (didn't bet)
Seat 7: TrankTank folded before Flop (didn't bet)
Seat 8: dzhonijs_e folded before Flop (didn't bet)
Seat 9: Elvis ah ha folded before Flop (didn't bet)



PokerStars Zoom Hand #216383687886:  Hold'em No Limit ($0.01/$0.02) - 2020/07/13 19:46:06 CET [2020/07/13 13:46:06 ET]
Table 'McNaught' 9-max Seat #1 is the button
Seat 1: pumpedli ($3.47 in chips) 
Seat 2: TheBlade8525 ($4.82 in chips) 
Seat 3: BadBeat Bert ($3.89 in chips) 
Seat 4: Aveena2 ($2 in chips) 
Seat 5: red_81_2009 ($1.91 in chips) 
Seat 6: Pentonomix ($3.03 in chips) 
Seat 7: J0SHB0SH ($2 in chips) 
Seat 8: TrankTank ($4.02 in chips) 
Seat 9: FelixFerrari ($1.41 in chips) 
TheBlade8525: posts small blind $0.01
BadBeat Bert: posts big blind $0.02
*** HOLE CARDS ***
Dealt to TrankTank [8h 8s]
Aveena2: folds 
red_81_2009: folds 
Pentonomix: raises $0.04 to $0.06
J0SHB0SH: raises $0.15 to $0.21
TrankTank: folds 
FelixFerrari: folds 
pumpedli: folds 
TheBlade8525: folds 
BadBeat Bert: folds 
Pentonomix: calls $0.15
*** FLOP *** [3c 2d Kd]
Pentonomix: bets $0.24
J0SHB0SH: raises $0.24 to $0.48
Pentonomix: folds 
Uncalled bet ($0.24) returned to J0SHB0SH
J0SHB0SH collected $0.90 from pot
J0SHB0SH: doesn't show hand 
*** SUMMARY ***
Total pot $0.93 | Rake $0.03 
Board [3c 2d Kd]
Seat 1: pumpedli (button) folded before Flop (didn't bet)
Seat 2: TheBlade8525 (small blind) folded before Flop
Seat 3: BadBeat Bert (big blind) folded before Flop
Seat 4: Aveena2 folded before Flop (didn't bet)
Seat 5: red_81_2009 folded before Flop (didn't bet)
Seat 6: Pentonomix folded on the Flop
Seat 7: J0SHB0SH collected ($0.90)
Seat 8: TrankTank folded before Flop (didn't bet)
Seat 9: FelixFerrari folded before Flop (didn't bet)



PokerStars Zoom Hand #216383703104:  Hold'em No Limit ($0.01/$0.02) - 2020/07/13 19:46:33 CET [2020/07/13 13:46:33 ET]
Table 'McNaught' 9-max Seat #1 is the button
Seat 1: Luisk2293 ($2 in chips) 
Seat 2: pellion ($1.93 in chips) 
Seat 3: Aveena2 ($2.02 in chips) 
Seat 4: TrankTank ($4.02 in chips) 
Seat 5: partizan_vlg ($1.04 in chips) 
Seat 6: dorro61966 ($3.09 in chips) 
Seat 7: Trainerst ($2.83 in chips) 
Seat 8: hurla64 ($2.03 in chips) 
Seat 9: grunge&punk ($2 in chips) 
pellion: posts small blind $0.01
Aveena2: posts big blind $0.02
*** HOLE CARDS ***
Dealt to TrankTank [Jc 8h]
TrankTank: folds 
partizan_vlg: folds 
dorro61966: folds 
Trainerst: calls $0.02
hurla64: folds 
grunge&punk: folds 
Luisk2293: folds 
pellion: folds 
Aveena2: raises $0.08 to $0.10
Trainerst: calls $0.08
*** FLOP *** [Qd Qh 8s]
Aveena2: bets $0.20
Trainerst: folds 
Uncalled bet ($0.20) returned to Aveena2
Aveena2 collected $0.20 from pot
Aveena2: doesn't show hand 
*** SUMMARY ***
Total pot $0.21 | Rake $0.01 
Board [Qd Qh 8s]
Seat 1: Luisk2293 (button) folded before Flop (didn't bet)
Seat 2: pellion (small blind) folded before Flop
Seat 3: Aveena2 (big blind) collected ($0.20)
Seat 4: TrankTank folded before Flop (didn't bet)
Seat 5: partizan_vlg folded before Flop (didn't bet)
Seat 6: dorro61966 folded before Flop (didn't bet)
Seat 7: Trainerst folded on the Flop
Seat 8: hurla64 folded before Flop (didn't bet)
Seat 9: grunge&punk folded before Flop (didn't bet)



PokerStars Zoom Hand #216383716377:  Hold'em No Limit ($0.01/$0.02) - 2020/07/13 19:46:57 CET [2020/07/13 13:46:57 ET]
Table 'McNaught' 9-max Seat #1 is the button
Seat 1: Herman1978 ($0.80 in chips) 
Seat 2: pumpedli ($2.04 in chips) 
Seat 3: TrankTank ($4.02 in chips) 
Seat 4: AndronDJ ($7.76 in chips) 
Seat 5: PhilB111 ($2.11 in chips) 
Seat 6: River_GmbH ($1.30 in chips) 
Seat 7: hurla64 ($11.04 in chips) 
Seat 8: pellion ($1.92 in chips) 
Seat 9: linkk1075 ($10.81 in chips) 
pumpedli: posts small blind $0.01
TrankTank: posts big blind $0.02
*** HOLE CARDS ***
Dealt to TrankTank [3h Ad]
AndronDJ: folds 
PhilB111 is disconnected 
PhilB111: raises $0.05 to $0.07
River_GmbH: folds 
hurla64: folds 
pellion: folds 
linkk1075: calls $0.07
Herman1978: folds 
pumpedli: folds 
TrankTank: folds 
*** FLOP *** [6d Ks 7h]
PhilB111: bets $0.16
linkk1075: calls $0.16
*** TURN *** [6d Ks 7h] [6h]
PhilB111: bets $0.47
linkk1075: folds 
Uncalled bet ($0.47) returned to PhilB111
PhilB111 collected $0.47 from pot
PhilB111: doesn't show hand 
*** SUMMARY ***
Total pot $0.49 | Rake $0.02 
Board [6d Ks 7h 6h]
Seat 1: Herman1978 (button) folded before Flop (didn't bet)
Seat 2: pumpedli (small blind) folded before Flop
Seat 3: TrankTank (big blind) folded before Flop
Seat 4: AndronDJ folded before Flop (didn't bet)
Seat 5: PhilB111 collected ($0.47)
Seat 6: River_GmbH folded before Flop (didn't bet)
Seat 7: hurla64 folded before Flop (didn't bet)
Seat 8: pellion folded before Flop (didn't bet)
Seat 9: linkk1075 folded on the Turn



PokerStars Zoom Hand #216383727931:  Hold'em No Limit ($0.01/$0.02) - 2020/07/13 19:47:18 CET [2020/07/13 13:47:18 ET]
Table 'McNaught' 9-max Seat #1 is the button
Seat 1: Aveena2 ($2 in chips) 
Seat 2: FelixFerrari ($1.24 in chips) 
Seat 3: Chev.de Mere ($0.82 in chips) 
Seat 4: Rummy41 ($3.08 in chips) 
Seat 5: Luisk2293 ($2 in chips) 
Seat 6: partizan_vlg ($1.03 in chips) 
Seat 7: TheBlade8525 ($4.71 in chips) 
Seat 8: niko16321 ($1.71 in chips) 
Seat 9: TrankTank ($4 in chips) 
FelixFerrari: posts small blind $0.01
Chev.de Mere: posts big blind $0.02
*** HOLE CARDS ***
Dealt to TrankTank [2c 8c]
Rummy41: folds 
Luisk2293: folds 
partizan_vlg: folds 
TheBlade8525: folds 
niko16321 has timed out
niko16321: folds 
TrankTank: folds 
Aveena2: folds 
FelixFerrari: raises $0.04 to $0.06
Chev.de Mere: folds 
Uncalled bet ($0.04) returned to FelixFerrari
FelixFerrari collected $0.04 from pot
FelixFerrari: doesn't show hand 
*** SUMMARY ***
Total pot $0.04 | Rake $0 
Seat 1: Aveena2 (button) folded before Flop (didn't bet)
Seat 2: FelixFerrari (small blind) collected ($0.04)
Seat 3: Chev.de Mere (big blind) folded before Flop
Seat 4: Rummy41 folded before Flop (didn't bet)
Seat 5: Luisk2293 folded before Flop (didn't bet)
Seat 6: partizan_vlg folded before Flop (didn't bet)
Seat 7: TheBlade8525 folded before Flop (didn't bet)
Seat 8: niko16321 folded before Flop (didn't bet)
Seat 9: TrankTank folded before Flop (didn't bet)



PokerStars Zoom Hand #216383709217:  Hold'em No Limit ($0.01/$0.02) - 2020/07/13 19:46:44 CET [2020/07/13 13:46:44 ET]
Table 'McNaught' 9-max Seat #1 is the button
Seat 1: Brixx440 ($4.60 in chips) 
Seat 2: ALF_70 ($1.93 in chips) 
Seat 3: River_GmbH ($1.32 in chips) 
Seat 4: GaliRah ($2.35 in chips) 
Seat 5: patkosmpa ($2.01 in chips) 
Seat 6: TrankTank ($4.02 in chips) 
Seat 7: BONECA DELICADA ($1.72 in chips) 
Seat 8: Luisk2293 ($2 in chips) 
Seat 9: Rummy41 ($3.08 in chips) 
ALF_70: posts small blind $0.01
River_GmbH: posts big blind $0.02
*** HOLE CARDS ***
Dealt to TrankTank [4s Ks]
GaliRah: folds 
patkosmpa: raises $0.04 to $0.06
TrankTank: folds 
BONECA DELICADA: folds 
Luisk2293: folds 
Rummy41: folds 
Brixx440: calls $0.06
ALF_70: folds 
River_GmbH: folds 
*** FLOP *** [3d 9s 2s]
patkosmpa: checks 
Brixx440: checks 
*** TURN *** [3d 9s 2s] [Qs]
patkosmpa: checks 
Brixx440: bets $0.07
patkosmpa: calls $0.07
*** RIVER *** [3d 9s 2s Qs] [4h]
patkosmpa: checks 
Brixx440: bets $0.12
patkosmpa: calls $0.12
*** SHOW DOWN ***
Brixx440: shows [Td Jd] (high card Queen)
patkosmpa: shows [Ac Qh] (a pair of Queens)
patkosmpa collected $0.51 from pot
*** SUMMARY ***
Total pot $0.53 | Rake $0.02 
Board [3d 9s 2s Qs 4h]
Seat 1: Brixx440 (button) showed [Td Jd] and lost with high card Queen
Seat 2: ALF_70 (small blind) folded before Flop
Seat 3: River_GmbH (big blind) folded before Flop
Seat 4: GaliRah folded before Flop (didn't bet)
Seat 5: patkosmpa showed [Ac Qh] and won ($0.51) with a pair of Queens
Seat 6: TrankTank folded before Flop (didn't bet)
Seat 7: BONECA DELICADA folded before Flop (didn't bet)
Seat 8: Luisk2293 folded before Flop (didn't bet)
Seat 9: Rummy41 folded before Flop (didn't bet)



PokerStars Zoom Hand #216383734005:  Hold'em No Limit ($0.01/$0.02) - 2020/07/13 19:47:29 CET [2020/07/13 13:47:29 ET]
Table 'McNaught' 9-max Seat #1 is the button
Seat 1: grunge&punk ($7.25 in chips) 
Seat 2: TrankTank ($4 in chips) 
Seat 3: Mizepa ($3.30 in chips) 
Seat 4: BONECA DELICADA ($1.58 in chips) 
Seat 5: bugsbunnies ($0.89 in chips) 
Seat 6: Luisk2293 ($2 in chips) 
Seat 7: RyuInShadow ($1.80 in chips) 
Seat 8: pumpedli ($2.82 in chips) 
Seat 9: GrafGo999 ($1.24 in chips) 
TrankTank: posts small blind $0.01
Mizepa: posts big blind $0.02
*** HOLE CARDS ***
Dealt to TrankTank [9d 5h]
BONECA DELICADA: folds 
bugsbunnies: folds 
Luisk2293: folds 
RyuInShadow: raises $0.04 to $0.06
pumpedli: folds 
GrafGo999: calls $0.06
grunge&punk: folds 
TrankTank: folds 
Mizepa: folds 
*** FLOP *** [Jh Kc Ks]
RyuInShadow: bets $0.06
GrafGo999: folds 
Uncalled bet ($0.06) returned to RyuInShadow
RyuInShadow collected $0.14 from pot
RyuInShadow: doesn't show hand 
*** SUMMARY ***
Total pot $0.15 | Rake $0.01 
Board [Jh Kc Ks]
Seat 1: grunge&punk (button) folded before Flop (didn't bet)
Seat 2: TrankTank (small blind) folded before Flop
Seat 3: Mizepa (big blind) folded before Flop
Seat 4: BONECA DELICADA folded before Flop (didn't bet)
Seat 5: bugsbunnies folded before Flop (didn't bet)
Seat 6: Luisk2293 folded before Flop (didn't bet)
Seat 7: RyuInShadow collected ($0.14)
Seat 8: pumpedli folded before Flop (didn't bet)
Seat 9: GrafGo999 folded on the Flop



PokerStars Zoom Hand #216383742338:  Hold'em No Limit ($0.01/$0.02) - 2020/07/13 19:47:44 CET [2020/07/13 13:47:44 ET]
Table 'McNaught' 9-max Seat #1 is the button
Seat 1: TrankTank ($3.99 in chips) 
Seat 2: oanhoanh ($2.51 in chips) 
Seat 3: Djig1t ($2 in chips) 
Seat 4: STYNG01 ($3.04 in chips) 
Seat 5: cuzmich500 ($1.65 in chips) 
Seat 6: qtmm ($2.09 in chips) 
Seat 7: ggGoldenPunk ($1.99 in chips) 
Seat 8: grunge&punk ($7.25 in chips) 
Seat 9: BONECA DELICADA ($1.69 in chips) 
oanhoanh: posts small blind $0.01
Djig1t: posts big blind $0.02
*** HOLE CARDS ***
Dealt to TrankTank [8c Jh]
STYNG01: folds 
cuzmich500: folds 
qtmm: raises $0.04 to $0.06
ggGoldenPunk: folds 
grunge&punk: folds 
BONECA DELICADA: folds 
TrankTank: folds 
oanhoanh: folds 
Djig1t: folds 
Uncalled bet ($0.04) returned to qtmm
qtmm collected $0.05 from pot
qtmm: doesn't show hand 
*** SUMMARY ***
Total pot $0.05 | Rake $0 
Seat 1: TrankTank (button) folded before Flop (didn't bet)
Seat 2: oanhoanh (small blind) folded before Flop
Seat 3: Djig1t (big blind) folded before Flop
Seat 4: STYNG01 folded before Flop (didn't bet)
Seat 5: cuzmich500 folded before Flop (didn't bet)
Seat 6: qtmm collected ($0.05)
Seat 7: ggGoldenPunk folded before Flop (didn't bet)
Seat 8: grunge&punk folded before Flop (didn't bet)
Seat 9: BONECA DELICADA folded before Flop (didn't bet)



PokerStars Zoom Hand #216383745641:  Hold'em No Limit ($0.01/$0.02) - 2020/07/13 19:47:50 CET [2020/07/13 13:47:50 ET]
Table 'McNaught' 9-max Seat #1 is the button
Seat 1: papatomi4 ($2.42 in chips) 
Seat 2: asvdm84 ($1.90 in chips) 
Seat 3: cuzmich500 ($1.65 in chips) 
Seat 4: Mizepa ($3.28 in chips) 
Seat 5: niko16321 ($1.71 in chips) 
Seat 6: grunge&punk ($7.25 in chips) 
Seat 7: TrankTank ($3.99 in chips) 
Seat 8: AdaiRu888 ($2 in chips) 
Seat 9: ggGoldenPunk ($3.63 in chips) 
asvdm84: posts small blind $0.01
cuzmich500: posts big blind $0.02
*** HOLE CARDS ***
Dealt to TrankTank [7h Kh]
Mizepa: folds 
niko16321: folds 
grunge&punk: folds 
TrankTank: folds 
AdaiRu888: folds 
ggGoldenPunk: folds 
papatomi4: folds 
asvdm84: folds 
Uncalled bet ($0.01) returned to cuzmich500
cuzmich500 collected $0.02 from pot
cuzmich500: doesn't show hand 
*** SUMMARY ***
Total pot $0.02 | Rake $0 
Seat 1: papatomi4 (button) folded before Flop (didn't bet)
Seat 2: asvdm84 (small blind) folded before Flop
Seat 3: cuzmich500 (big blind) collected ($0.02)
Seat 4: Mizepa folded before Flop (didn't bet)
Seat 5: niko16321 folded before Flop (didn't bet)
Seat 6: grunge&punk folded before Flop (didn't bet)
Seat 7: TrankTank folded before Flop (didn't bet)
Seat 8: AdaiRu888 folded before Flop (didn't bet)
Seat 9: ggGoldenPunk folded before Flop (didn't bet)



PokerStars Zoom Hand #216383753468:  Hold'em No Limit ($0.01/$0.02) - 2020/07/13 19:48:04 CET [2020/07/13 13:48:04 ET]
Table 'McNaught' 9-max Seat #1 is the button
Seat 1: Mara6111 ($3.44 in chips) 
Seat 2: Fostal_by ($2.43 in chips) 
Seat 3: pumpedli ($2.82 in chips) 
Seat 4: grunge&punk ($7.25 in chips) 
Seat 5: TrankTank ($3.99 in chips) 
Seat 6: Herman1978 ($0.74 in chips) 
Seat 7: Skydomes ($2.81 in chips) 
Seat 8: TheBlade8525 ($4.68 in chips) 
Seat 9: J0SHB0SH ($2.31 in chips) 
Fostal_by: posts small blind $0.01
pumpedli: posts big blind $0.02
*** HOLE CARDS ***
Dealt to TrankTank [2c Js]
grunge&punk: folds 
TrankTank: folds 
Herman1978: calls $0.02
Skydomes: folds 
TheBlade8525: folds 
J0SHB0SH: folds 
Mara6111: folds 
Fostal_by: raises $0.09 to $0.11
pumpedli: folds 
Herman1978: calls $0.09
*** FLOP *** [Qs Jc 8c]
Fostal_by: bets $0.12
Herman1978: folds 
Uncalled bet ($0.12) returned to Fostal_by
Fostal_by collected $0.23 from pot
Fostal_by: doesn't show hand 
*** SUMMARY ***
Total pot $0.24 | Rake $0.01 
Board [Qs Jc 8c]
Seat 1: Mara6111 (button) folded before Flop (didn't bet)
Seat 2: Fostal_by (small blind) collected ($0.23)
Seat 3: pumpedli (big blind) folded before Flop
Seat 4: grunge&punk folded before Flop (didn't bet)
Seat 5: TrankTank folded before Flop (didn't bet)
Seat 6: Herman1978 folded on the Flop
Seat 7: Skydomes folded before Flop (didn't bet)
Seat 8: TheBlade8525 folded before Flop (didn't bet)
Seat 9: J0SHB0SH folded before Flop (didn't bet)



PokerStars Zoom Hand #216383757856:  Hold'em No Limit ($0.01/$0.02) - 2020/07/13 19:48:12 CET [2020/07/13 13:48:12 ET]
Table 'McNaught' 9-max Seat #1 is the button
Seat 1: Nimajuan ($1.19 in chips) 
Seat 2: Akiwjuh ($0.34 in chips) 
Seat 3: Iron208 ($2.09 in chips) 
Seat 4: ggGoldenPunk ($3.62 in chips) 
Seat 5: papatomi4 ($2.42 in chips) 
Seat 6: EliFilho55 ($4 in chips) 
Seat 7: Hese_8 ($1.95 in chips) 
Seat 8: TrankTank ($3.99 in chips) 
Seat 9: sayatsemey ($3.77 in chips) 
Akiwjuh: posts small blind $0.01
Iron208: posts big blind $0.02
*** HOLE CARDS ***
Dealt to TrankTank [2c 6s]
Akiwjuh is disconnected 
ggGoldenPunk: raises $0.04 to $0.06
papatomi4: folds 
EliFilho55: folds 
Hese_8: folds 
TrankTank: folds 
sayatsemey: folds 
Nimajuan: calls $0.06
Akiwjuh: folds 
Iron208: folds 
*** FLOP *** [As Kd 9s]
ggGoldenPunk: bets $0.02
Nimajuan: calls $0.02
*** TURN *** [As Kd 9s] [2d]
ggGoldenPunk: checks 
Nimajuan: checks 
*** RIVER *** [As Kd 9s 2d] [5s]
ggGoldenPunk: checks 
Nimajuan: bets $0.36
ggGoldenPunk: folds 
Uncalled bet ($0.36) returned to Nimajuan
Nimajuan collected $0.18 from pot
Nimajuan: doesn't show hand 
*** SUMMARY ***
Total pot $0.19 | Rake $0.01 
Board [As Kd 9s 2d 5s]
Seat 1: Nimajuan (button) collected ($0.18)
Seat 2: Akiwjuh (small blind) folded before Flop
Seat 3: Iron208 (big blind) folded before Flop
Seat 4: ggGoldenPunk folded on the River
Seat 5: papatomi4 folded before Flop (didn't bet)
Seat 6: EliFilho55 folded before Flop (didn't bet)
Seat 7: Hese_8 folded before Flop (didn't bet)
Seat 8: TrankTank folded before Flop (didn't bet)
Seat 9: sayatsemey folded before Flop (didn't bet)



PokerStars Zoom Hand #216383768406:  Hold'em No Limit ($0.01/$0.02) - 2020/07/13 19:48:31 CET [2020/07/13 13:48:31 ET]
Table 'McNaught' 9-max Seat #1 is the button
Seat 1: sayatsemey ($2.27 in chips) 
Seat 2: tomashovka55 ($2.30 in chips) 
Seat 3: SUPERNUNO ($1.84 in chips) 
Seat 4: Aveena2 ($2.09 in chips) 
Seat 5: joehlavicka ($4.20 in chips) 
Seat 6: TrankTank ($3.99 in chips) 
Seat 7: TheBlade8525 ($4.76 in chips) 
Seat 8: Fostal_by ($2.55 in chips) 
Seat 9: STYNG01 ($17.50 in chips) 
tomashovka55: posts small blind $0.01
SUPERNUNO: posts big blind $0.02
*** HOLE CARDS ***
Dealt to TrankTank [7h 9d]
Aveena2: folds 
joehlavicka: folds 
TrankTank: folds 
TheBlade8525: folds 
Fostal_by: folds 
STYNG01: folds 
sayatsemey: raises $0.04 to $0.06
tomashovka55: folds 
SUPERNUNO: folds 
Uncalled bet ($0.04) returned to sayatsemey
sayatsemey collected $0.05 from pot
sayatsemey: doesn't show hand 
*** SUMMARY ***
Total pot $0.05 | Rake $0 
Seat 1: sayatsemey (button) collected ($0.05)
Seat 2: tomashovka55 (small blind) folded before Flop
Seat 3: SUPERNUNO (big blind) folded before Flop
Seat 4: Aveena2 folded before Flop (didn't bet)
Seat 5: joehlavicka folded before Flop (didn't bet)
Seat 6: TrankTank folded before Flop (didn't bet)
Seat 7: TheBlade8525 folded before Flop (didn't bet)
Seat 8: Fostal_by folded before Flop (didn't bet)
Seat 9: STYNG01 folded before Flop (didn't bet)



PokerStars Zoom Hand #216383763416:  Hold'em No Limit ($0.01/$0.02) - 2020/07/13 19:48:22 CET [2020/07/13 13:48:22 ET]
Table 'McNaught' 9-max Seat #1 is the button
Seat 1: BadBeat Bert ($3.78 in chips) 
Seat 2: EthernalPablo ($0.14 in chips) 
Seat 3: sayatsemey ($3.77 in chips) 
Seat 4: TrankTank ($3.99 in chips) 
Seat 5: EliFilho55 ($4 in chips) 
Seat 6: pumpedli ($2 in chips) 
Seat 7: Mizepa ($2.53 in chips) 
Seat 8: Krimil ($0.97 in chips) 
Seat 9: Runway26 ($2 in chips) 
EthernalPablo: posts small blind $0.01
sayatsemey: posts big blind $0.02
*** HOLE CARDS ***
Dealt to TrankTank [5d 2c]
TrankTank: folds 
EliFilho55: folds 
pumpedli: folds 
Mizepa: folds 
Krimil: calls $0.02
Runway26: folds 
BadBeat Bert: folds 
EthernalPablo: folds 
sayatsemey: checks 
*** FLOP *** [Jc 7c 9c]
sayatsemey: bets $0.05
Krimil: calls $0.05
*** TURN *** [Jc 7c 9c] [4h]
sayatsemey: bets $0.14
Krimil: calls $0.14
*** RIVER *** [Jc 7c 9c 4h] [9h]
sayatsemey: bets $0.21
Krimil: folds 
Uncalled bet ($0.21) returned to sayatsemey
sayatsemey collected $0.41 from pot
sayatsemey: doesn't show hand 
*** SUMMARY ***
Total pot $0.43 | Rake $0.02 
Board [Jc 7c 9c 4h 9h]
Seat 1: BadBeat Bert (button) folded before Flop (didn't bet)
Seat 2: EthernalPablo (small blind) folded before Flop
Seat 3: sayatsemey (big blind) collected ($0.41)
Seat 4: TrankTank folded before Flop (didn't bet)
Seat 5: EliFilho55 folded before Flop (didn't bet)
Seat 6: pumpedli folded before Flop (didn't bet)
Seat 7: Mizepa folded before Flop (didn't bet)
Seat 8: Krimil folded on the River
Seat 9: Runway26 folded before Flop (didn't bet)



PokerStars Zoom Hand #216383771747:  Hold'em No Limit ($0.01/$0.02) - 2020/07/13 19:48:37 CET [2020/07/13 13:48:37 ET]
Table 'McNaught' 9-max Seat #1 is the button
Seat 1: pellion ($2.12 in chips) 
Seat 2: STYNG01 ($6.26 in chips) 
Seat 3: TrankTank ($3.99 in chips) 
Seat 4: pumpedli ($2 in chips) 
Seat 5: hurla64 ($2 in chips) 
Seat 6: bugsbunnies ($0.94 in chips) 
Seat 7: Fostal_by ($2.55 in chips) 
Seat 8: weiting777 ($2.06 in chips) 
Seat 9: tomashovka55 ($2.29 in chips) 
STYNG01: posts small blind $0.01
TrankTank: posts big blind $0.02
*** HOLE CARDS ***
Dealt to TrankTank [7s Ts]
pumpedli: folds 
hurla64: folds 
bugsbunnies: folds 
Fostal_by: folds 
weiting777: raises $0.04 to $0.06
tomashovka55: folds 
pellion: folds 
STYNG01: folds 
TrankTank: folds 
Uncalled bet ($0.04) returned to weiting777
weiting777 collected $0.05 from pot
weiting777: doesn't show hand 
*** SUMMARY ***
Total pot $0.05 | Rake $0 
Seat 1: pellion (button) folded before Flop (didn't bet)
Seat 2: STYNG01 (small blind) folded before Flop
Seat 3: TrankTank (big blind) folded before Flop
Seat 4: pumpedli folded before Flop (didn't bet)
Seat 5: hurla64 folded before Flop (didn't bet)
Seat 6: bugsbunnies folded before Flop (didn't bet)
Seat 7: Fostal_by folded before Flop (didn't bet)
Seat 8: weiting777 collected ($0.05)
Seat 9: tomashovka55 folded before Flop (didn't bet)



PokerStars Zoom Hand #216383785167:  Hold'em No Limit ($0.01/$0.02) - 2020/07/13 19:49:01 CET [2020/07/13 13:49:01 ET]
Table 'McNaught' 9-max Seat #1 is the button
Seat 1: smoke1ne ($4.02 in chips) 
Seat 2: BerenKamlost ($3.15 in chips) 
Seat 3: red_81_2009 ($1.79 in chips) 
Seat 4: TrankTank ($3.97 in chips) 
Seat 5: Mizepa ($2.27 in chips) 
Seat 6: tomashovka55 ($2.29 in chips) 
Seat 7: FelixFerrari ($2.25 in chips) 
Seat 8: STYNG01 ($3.04 in chips) 
Seat 9: Djig1t ($2 in chips) 
BerenKamlost: posts small blind $0.01
red_81_2009: posts big blind $0.02
*** HOLE CARDS ***
Dealt to TrankTank [2d As]
TrankTank: folds 
Mizepa: folds 
tomashovka55: folds 
FelixFerrari: folds 
STYNG01: folds 
Djig1t: folds 
smoke1ne: folds 
BerenKamlost: raises $0.02 to $0.04
red_81_2009: calls $0.02
*** FLOP *** [6s Ac Td]
BerenKamlost: checks 
red_81_2009: checks 
*** TURN *** [6s Ac Td] [Kc]
BerenKamlost: checks 
red_81_2009: checks 
*** RIVER *** [6s Ac Td Kc] [9s]
BerenKamlost: checks 
red_81_2009: bets $0.06
BerenKamlost: folds 
Uncalled bet ($0.06) returned to red_81_2009
red_81_2009 collected $0.08 from pot
red_81_2009: doesn't show hand 
*** SUMMARY ***
Total pot $0.08 | Rake $0 
Board [6s Ac Td Kc 9s]
Seat 1: smoke1ne (button) folded before Flop (didn't bet)
Seat 2: BerenKamlost (small blind) folded on the River
Seat 3: red_81_2009 (big blind) collected ($0.08)
Seat 4: TrankTank folded before Flop (didn't bet)
Seat 5: Mizepa folded before Flop (didn't bet)
Seat 6: tomashovka55 folded before Flop (didn't bet)
Seat 7: FelixFerrari folded before Flop (didn't bet)
Seat 8: STYNG01 folded before Flop (didn't bet)
Seat 9: Djig1t folded before Flop (didn't bet)



PokerStars Zoom Hand #216383807282:  Hold'em No Limit ($0.01/$0.02) - 2020/07/13 19:49:41 CET [2020/07/13 13:49:41 ET]
Table 'McNaught' 9-max Seat #1 is the button
Seat 1: partizan_vlg ($0.97 in chips) 
Seat 2: sayatsemey ($2.30 in chips) 
Seat 3: ggGoldenPunk ($3.62 in chips) 
Seat 4: niko16321 ($1.75 in chips) 
Seat 5: TrankTank ($3.96 in chips) 
Seat 6: pisqnek ($2.06 in chips) 
Seat 7: tomashovka55 ($2.01 in chips) 
Seat 8: Djig1t ($2 in chips) 
Seat 9: Luisk2293 ($2.01 in chips) 
sayatsemey: posts small blind $0.01
ggGoldenPunk: posts big blind $0.02
*** HOLE CARDS ***
Dealt to TrankTank [Kd 9s]
niko16321: folds 
TrankTank: folds 
pisqnek: folds 
tomashovka55: folds 
Djig1t: folds 
Luisk2293: raises $0.03 to $0.05
partizan_vlg: folds 
sayatsemey: folds 
ggGoldenPunk: folds 
Uncalled bet ($0.03) returned to Luisk2293
Luisk2293 collected $0.05 from pot
Luisk2293: doesn't show hand 
*** SUMMARY ***
Total pot $0.05 | Rake $0 
Seat 1: partizan_vlg (button) folded before Flop (didn't bet)
Seat 2: sayatsemey (small blind) folded before Flop
Seat 3: ggGoldenPunk (big blind) folded before Flop
Seat 4: niko16321 folded before Flop (didn't bet)
Seat 5: TrankTank folded before Flop (didn't bet)
Seat 6: pisqnek folded before Flop (didn't bet)
Seat 7: tomashovka55 folded before Flop (didn't bet)
Seat 8: Djig1t folded before Flop (didn't bet)
Seat 9: Luisk2293 collected ($0.05)



PokerStars Zoom Hand #216383787952:  Hold'em No Limit ($0.01/$0.02) - 2020/07/13 19:49:06 CET [2020/07/13 13:49:06 ET]
Table 'McNaught' 9-max Seat #1 is the button
Seat 1: AdaiRu888 ($2.01 in chips) 
Seat 2: TrankTank ($3.97 in chips) 
Seat 3: FelixFerrari ($2.25 in chips) 
Seat 4: Elvis ah ha ($2.48 in chips) 
Seat 5: hurla64 ($2 in chips) 
Seat 6: STYNG01 ($3.04 in chips) 
Seat 7: sayatsemey ($2.30 in chips) 
Seat 8: Iron208 ($2 in chips) 
Seat 9: snow9001 ($2 in chips) 
TrankTank: posts small blind $0.01
FelixFerrari: posts big blind $0.02
*** HOLE CARDS ***
Dealt to TrankTank [8s Td]
Elvis ah ha has timed out
Elvis ah ha: folds 
hurla64: folds 
STYNG01: raises $0.02 to $0.04
sayatsemey: folds 
Iron208: raises $0.10 to $0.14
snow9001: folds 
AdaiRu888: folds 
TrankTank: folds 
FelixFerrari: folds 
STYNG01: calls $0.10
*** FLOP *** [Ac Kd Ts]
STYNG01: checks 
Iron208: bets $0.14
STYNG01: calls $0.14
*** TURN *** [Ac Kd Ts] [2s]
STYNG01: checks 
Iron208: checks 
*** RIVER *** [Ac Kd Ts 2s] [Qs]
STYNG01: bets $0.38
Iron208: calls $0.38
*** SHOW DOWN ***
STYNG01: shows [Js Jc] (a straight, Ten to Ace)
Iron208: shows [Jd Jh] (a straight, Ten to Ace)
STYNG01 collected $0.65 from pot
Iron208 collected $0.65 from pot
*** SUMMARY ***
Total pot $1.35 | Rake $0.05 
Board [Ac Kd Ts 2s Qs]
Seat 1: AdaiRu888 (button) folded before Flop (didn't bet)
Seat 2: TrankTank (small blind) folded before Flop
Seat 3: FelixFerrari (big blind) folded before Flop
Seat 4: Elvis ah ha folded before Flop (didn't bet)
Seat 5: hurla64 folded before Flop (didn't bet)
Seat 6: STYNG01 showed [Js Jc] and won ($0.65) with a straight, Ten to Ace
Seat 7: sayatsemey folded before Flop (didn't bet)
Seat 8: Iron208 showed [Jd Jh] and won ($0.65) with a straight, Ten to Ace
Seat 9: snow9001 folded before Flop (didn't bet)



PokerStars Zoom Hand #216383804536:  Hold'em No Limit ($0.01/$0.02) - 2020/07/13 19:49:36 CET [2020/07/13 13:49:36 ET]
Table 'McNaught' 9-max Seat #1 is the button
Seat 1: TrankTank ($3.96 in chips) 
Seat 2: edeust ($2.10 in chips) 
Seat 3: cathousecat ($3.74 in chips) 
Seat 4: vovei83 ($2 in chips) 
Seat 5: AdaiRu888 ($2 in chips) 
Seat 6: FelixFerrari ($2.23 in chips) 
Seat 7: pocoyo088 ($2 in chips) 
Seat 8: Iron208 ($2 in chips) 
Seat 9: tomashovka55 ($2.01 in chips) 
edeust: posts small blind $0.01
cathousecat: posts big blind $0.02
*** HOLE CARDS ***
Dealt to TrankTank [2s Th]
vovei83: folds 
AdaiRu888: folds 
FelixFerrari: folds 
pocoyo088: raises $0.03 to $0.05
Iron208: folds 
tomashovka55: folds 
TrankTank: folds 
edeust: raises $0.15 to $0.20
cathousecat: folds 
pocoyo088: folds 
Uncalled bet ($0.15) returned to edeust
edeust collected $0.12 from pot
edeust: doesn't show hand 
*** SUMMARY ***
Total pot $0.12 | Rake $0 
Seat 1: TrankTank (button) folded before Flop (didn't bet)
Seat 2: edeust (small blind) collected ($0.12)
Seat 3: cathousecat (big blind) folded before Flop
Seat 4: vovei83 folded before Flop (didn't bet)
Seat 5: AdaiRu888 folded before Flop (didn't bet)
Seat 6: FelixFerrari folded before Flop (didn't bet)
Seat 7: pocoyo088 folded before Flop
Seat 8: Iron208 folded before Flop (didn't bet)
Seat 9: tomashovka55 folded before Flop (didn't bet)



PokerStars Zoom Hand #216383811691:  Hold'em No Limit ($0.01/$0.02) - 2020/07/13 19:49:49 CET [2020/07/13 13:49:49 ET]
Table 'McNaught' 9-max Seat #1 is the button
Seat 1: Emrama ($1 in chips) 
Seat 2: dori_vedimak ($1.74 in chips) 
Seat 3: partizan_vlg ($1.73 in chips) 
Seat 4: Tiggu ($1.69 in chips) 
Seat 5: HAL VAGYOK ($2.20 in chips) 
Seat 6: cuzmich500 ($3.69 in chips) 
Seat 7: STYNG01 ($17.48 in chips) 
Seat 8: pisqnek ($6.68 in chips) 
Seat 9: TrankTank ($3.96 in chips) 
dori_vedimak: posts small blind $0.01
partizan_vlg: posts big blind $0.02
*** HOLE CARDS ***
Dealt to TrankTank [Kc 5h]
Tiggu: folds 
HAL VAGYOK: folds 
cuzmich500: folds 
STYNG01: folds 
pisqnek: folds 
TrankTank: folds 
Emrama: raises $0.04 to $0.06
dori_vedimak: folds 
partizan_vlg: folds 
Uncalled bet ($0.04) returned to Emrama
Emrama collected $0.05 from pot
Emrama: doesn't show hand 
*** SUMMARY ***
Total pot $0.05 | Rake $0 
Seat 1: Emrama (button) collected ($0.05)
Seat 2: dori_vedimak (small blind) folded before Flop
Seat 3: partizan_vlg (big blind) folded before Flop
Seat 4: Tiggu folded before Flop (didn't bet)
Seat 5: HAL VAGYOK folded before Flop (didn't bet)
Seat 6: cuzmich500 folded before Flop (didn't bet)
Seat 7: STYNG01 folded before Flop (didn't bet)
Seat 8: pisqnek folded before Flop (didn't bet)
Seat 9: TrankTank folded before Flop (didn't bet)



PokerStars Zoom Hand #216383817797:  Hold'em No Limit ($0.01/$0.02) - 2020/07/13 19:50:00 CET [2020/07/13 13:50:00 ET]
Table 'McNaught' 9-max Seat #1 is the button
Seat 1: snow9001 ($2.28 in chips) 
Seat 2: J0SHB0SH ($2.39 in chips) 
Seat 3: Elvis ah ha ($2.37 in chips) 
Seat 4: wraggy225 ($6.08 in chips) 
Seat 5: jackbam993 ($0.47 in chips) 
Seat 6: RRigoletto ($1.74 in chips) 
Seat 7: smoke1ne ($3.99 in chips) 
Seat 8: TrankTank ($3.96 in chips) 
Seat 9: pellion ($1.95 in chips) 
J0SHB0SH: posts small blind $0.01
Elvis ah ha: posts big blind $0.02
*** HOLE CARDS ***
Dealt to TrankTank [As 5h]
wraggy225: folds 
jackbam993: folds 
RRigoletto: folds 
smoke1ne: folds 
TrankTank: folds 
pellion: folds 
snow9001 has timed out
snow9001: folds 
J0SHB0SH: folds 
Uncalled bet ($0.01) returned to Elvis ah ha
Elvis ah ha collected $0.02 from pot
Elvis ah ha: doesn't show hand 
*** SUMMARY ***
Total pot $0.02 | Rake $0 
Seat 1: snow9001 (button) folded before Flop (didn't bet)
Seat 2: J0SHB0SH (small blind) folded before Flop
Seat 3: Elvis ah ha (big blind) collected ($0.02)
Seat 4: wraggy225 folded before Flop (didn't bet)
Seat 5: jackbam993 folded before Flop (didn't bet)
Seat 6: RRigoletto folded before Flop (didn't bet)
Seat 7: smoke1ne folded before Flop (didn't bet)
Seat 8: TrankTank folded before Flop (didn't bet)
Seat 9: pellion folded before Flop (didn't bet)



PokerStars Zoom Hand #216383824447:  Hold'em No Limit ($0.01/$0.02) - 2020/07/13 19:50:12 CET [2020/07/13 13:50:12 ET]
Table 'McNaught' 9-max Seat #1 is the button
Seat 1: jackbam993 ($0.46 in chips) 
Seat 2: pisqnek ($2.04 in chips) 
Seat 3: grunge&punk ($2.40 in chips) 
Seat 4: TrankTank ($3.96 in chips) 
Seat 5: hurla64 ($2.61 in chips) 
Seat 6: patkosmpa ($2.64 in chips) 
Seat 7: ggGoldenPunk ($3.59 in chips) 
Seat 8: BONECA DELICADA ($1.63 in chips) 
Seat 9: linkk1075 ($10.35 in chips) 
pisqnek: posts small blind $0.01
grunge&punk: posts big blind $0.02
*** HOLE CARDS ***
Dealt to TrankTank [Th 7c]
TrankTank: folds 
hurla64: folds 
patkosmpa: folds 
ggGoldenPunk: folds 
BONECA DELICADA: raises $0.04 to $0.06
linkk1075: folds 
jackbam993: folds 
pisqnek: folds 
grunge&punk: folds 
Uncalled bet ($0.04) returned to BONECA DELICADA
BONECA DELICADA collected $0.05 from pot
BONECA DELICADA: doesn't show hand 
*** SUMMARY ***
Total pot $0.05 | Rake $0 
Seat 1: jackbam993 (button) folded before Flop (didn't bet)
Seat 2: pisqnek (small blind) folded before Flop
Seat 3: grunge&punk (big blind) folded before Flop
Seat 4: TrankTank folded before Flop (didn't bet)
Seat 5: hurla64 folded before Flop (didn't bet)
Seat 6: patkosmpa folded before Flop (didn't bet)
Seat 7: ggGoldenPunk folded before Flop (didn't bet)
Seat 8: BONECA DELICADA collected ($0.05)
Seat 9: linkk1075 folded before Flop (didn't bet)



PokerStars Zoom Hand #216383828283:  Hold'em No Limit ($0.01/$0.02) - 2020/07/13 19:50:19 CET [2020/07/13 13:50:19 ET]
Table 'McNaught' 9-max Seat #1 is the button
Seat 1: BadBeat Bert ($3.74 in chips) 
Seat 2: Brixx440 ($4.35 in chips) 
Seat 3: TrankTank ($3.96 in chips) 
Seat 4: xAndrzej-K ($6.35 in chips) 
Seat 5: AdaiRu888 ($2 in chips) 
Seat 6: tomashovka55 ($2.15 in chips) 
Seat 7: sayatsemey ($2.27 in chips) 
Seat 8: hurla64 ($10.98 in chips) 
Seat 9: pisqnek ($6.66 in chips) 
Brixx440: posts small blind $0.01
TrankTank: posts big blind $0.02
*** HOLE CARDS ***
Dealt to TrankTank [7c 5h]
xAndrzej-K: calls $0.02
AdaiRu888: folds 
tomashovka55: folds 
sayatsemey: folds 
hurla64: folds 
pisqnek: folds 
BadBeat Bert: folds 
Brixx440: folds 
TrankTank: checks 
*** FLOP *** [Jd 8c 3h]
TrankTank: checks 
xAndrzej-K: bets $0.06
TrankTank: folds 
Uncalled bet ($0.06) returned to xAndrzej-K
xAndrzej-K collected $0.05 from pot
*** SUMMARY ***
Total pot $0.05 | Rake $0 
Board [Jd 8c 3h]
Seat 1: BadBeat Bert (button) folded before Flop (didn't bet)
Seat 2: Brixx440 (small blind) folded before Flop
Seat 3: TrankTank (big blind) folded on the Flop
Seat 4: xAndrzej-K collected ($0.05)
Seat 5: AdaiRu888 folded before Flop (didn't bet)
Seat 6: tomashovka55 folded before Flop (didn't bet)
Seat 7: sayatsemey folded before Flop (didn't bet)
Seat 8: hurla64 folded before Flop (didn't bet)
Seat 9: pisqnek folded before Flop (didn't bet)



PokerStars Zoom Hand #216383844958:  Hold'em No Limit ($0.01/$0.02) - 2020/07/13 19:50:49 CET [2020/07/13 13:50:49 ET]
Table 'McNaught' 9-max Seat #1 is the button
Seat 1: pisqnek ($2.49 in chips) 
Seat 2: hurla64 ($2.47 in chips) 
Seat 3: STYNG01 ($3.11 in chips) 
Seat 4: GaliRah ($2.09 in chips) 
Seat 5: Emrama ($1 in chips) 
Seat 6: olegch3 ($2 in chips) 
Seat 7: TrankTank ($3.94 in chips) 
Seat 8: ALF_70 ($1.62 in chips) 
Seat 9: musse222 ($1.88 in chips) 
hurla64: posts small blind $0.01
STYNG01: posts big blind $0.02
*** HOLE CARDS ***
Dealt to TrankTank [Qd As]
GaliRah: folds 
Emrama: folds 
olegch3: folds 
TrankTank: raises $0.04 to $0.06
ALF_70: folds 
musse222: calls $0.06
pisqnek: folds 
hurla64: folds 
STYNG01: folds 
*** FLOP *** [7d 2h 2d]
TrankTank: bets $0.10
musse222: folds 
Uncalled bet ($0.10) returned to TrankTank
TrankTank collected $0.14 from pot
TrankTank: doesn't show hand 
*** SUMMARY ***
Total pot $0.15 | Rake $0.01 
Board [7d 2h 2d]
Seat 1: pisqnek (button) folded before Flop (didn't bet)
Seat 2: hurla64 (small blind) folded before Flop
Seat 3: STYNG01 (big blind) folded before Flop
Seat 4: GaliRah folded before Flop (didn't bet)
Seat 5: Emrama folded before Flop (didn't bet)
Seat 6: olegch3 folded before Flop (didn't bet)
Seat 7: TrankTank collected ($0.14)
Seat 8: ALF_70 folded before Flop (didn't bet)
Seat 9: musse222 folded on the Flop



PokerStars Zoom Hand #216383857059:  Hold'em No Limit ($0.01/$0.02) - 2020/07/13 19:51:11 CET [2020/07/13 13:51:11 ET]
Table 'McNaught' 9-max Seat #1 is the button
Seat 1: tomashovka55 ($2.05 in chips) 
Seat 2: TrankTank ($4.02 in chips) 
Seat 3: STYNG01 ($17.45 in chips) 
Seat 4: HAL VAGYOK ($2.65 in chips) 
Seat 5: gersomen2791 ($3.29 in chips) 
Seat 6: hurla64 ($2.59 in chips) 
Seat 7: musse222 ($1.82 in chips) 
Seat 8: Iron208 ($2 in chips) 
Seat 9: Hese_8 ($1.72 in chips) 
TrankTank: posts small blind $0.01
STYNG01: posts big blind $0.02
*** HOLE CARDS ***
Dealt to TrankTank [2s 9d]
HAL VAGYOK: folds 
gersomen2791: folds 
hurla64: folds 
musse222: folds 
Iron208: folds 
Hese_8: folds 
tomashovka55: raises $0.04 to $0.06
TrankTank: folds 
STYNG01: folds 
Uncalled bet ($0.04) returned to tomashovka55
tomashovka55 collected $0.05 from pot
tomashovka55: doesn't show hand 
*** SUMMARY ***
Total pot $0.05 | Rake $0 
Seat 1: tomashovka55 (button) collected ($0.05)
Seat 2: TrankTank (small blind) folded before Flop
Seat 3: STYNG01 (big blind) folded before Flop
Seat 4: HAL VAGYOK folded before Flop (didn't bet)
Seat 5: gersomen2791 folded before Flop (didn't bet)
Seat 6: hurla64 folded before Flop (didn't bet)
Seat 7: musse222 folded before Flop (didn't bet)
Seat 8: Iron208 folded before Flop (didn't bet)
Seat 9: Hese_8 folded before Flop (didn't bet)



PokerStars Zoom Hand #216383860438:  Hold'em No Limit ($0.01/$0.02) - 2020/07/13 19:51:17 CET [2020/07/13 13:51:17 ET]
Table 'McNaught' 9-max Seat #1 is the button
Seat 1: Luisk2293 ($2 in chips) 
Seat 2: Kepas1 ($3.33 in chips) 
Seat 3: qtmm ($2.15 in chips) 
Seat 4: EliFilho55 ($3.98 in chips) 
Seat 5: pellion ($2.15 in chips) 
Seat 6: Djig1t ($2.18 in chips) 
Seat 7: Iron208 ($2 in chips) 
Seat 8: pocoyo088 ($2 in chips) 
Seat 9: TrankTank ($4.01 in chips) 
Kepas1: posts small blind $0.01
qtmm: posts big blind $0.02
*** HOLE CARDS ***
Dealt to TrankTank [Ah 9h]
EliFilho55: calls $0.02
pellion: calls $0.02
Djig1t: folds 
Iron208: calls $0.02
pocoyo088: folds 
TrankTank: calls $0.02
Luisk2293: calls $0.02
Kepas1: folds 
qtmm: checks 
*** FLOP *** [9s Tc 6s]
qtmm: checks 
EliFilho55: checks 
pellion: checks 
Iron208: bets $0.08
TrankTank: folds 
Luisk2293: folds 
qtmm: folds 
EliFilho55: folds 
pellion: calls $0.08
*** TURN *** [9s Tc 6s] [Th]
pellion: checks 
Iron208: checks 
*** RIVER *** [9s Tc 6s Th] [8d]
pellion: checks 
Iron208: bets $0.12
pellion: calls $0.12
*** SHOW DOWN ***
Iron208: shows [Js Jc] (two pair, Jacks and Tens)
pellion: shows [6c 7c] (a straight, Six to Ten)
pellion collected $0.51 from pot
*** SUMMARY ***
Total pot $0.53 | Rake $0.02 
Board [9s Tc 6s Th 8d]
Seat 1: Luisk2293 (button) folded on the Flop
Seat 2: Kepas1 (small blind) folded before Flop
Seat 3: qtmm (big blind) folded on the Flop
Seat 4: EliFilho55 folded on the Flop
Seat 5: pellion showed [6c 7c] and won ($0.51) with a straight, Six to Ten
Seat 6: Djig1t folded before Flop (didn't bet)
Seat 7: Iron208 showed [Js Jc] and lost with two pair, Jacks and Tens
Seat 8: pocoyo088 folded before Flop (didn't bet)
Seat 9: TrankTank folded on the Flop



PokerStars Zoom Hand #216383880512:  Hold'em No Limit ($0.01/$0.02) - 2020/07/13 19:51:53 CET [2020/07/13 13:51:53 ET]
Table 'McNaught' 9-max Seat #1 is the button
Seat 1: olegch3 ($2 in chips) 
Seat 2: Mara6111 ($3.45 in chips) 
Seat 3: R D J 1965 ($2.21 in chips) 
Seat 4: tomashovka55 ($4.22 in chips) 
Seat 5: murrie666 ($2.07 in chips) 
Seat 6: TrankTank ($3.99 in chips) 
Seat 7: pumpedli ($3.86 in chips) 
Seat 8: dorro61966 ($3.27 in chips) 
Seat 9: snow9001 ($2.34 in chips) 
Mara6111: posts small blind $0.01
R D J 1965: posts big blind $0.02
*** HOLE CARDS ***
Dealt to TrankTank [3c 7c]
tomashovka55: raises $0.06 to $0.08
murrie666: calls $0.08
TrankTank: folds 
pumpedli: folds 
dorro61966: folds 
snow9001: calls $0.08
olegch3: folds 
Mara6111: folds 
R D J 1965: folds 
*** FLOP *** [3d 2s As]
tomashovka55: bets $0.37
murrie666: folds 
snow9001: folds 
Uncalled bet ($0.37) returned to tomashovka55
tomashovka55 collected $0.26 from pot
tomashovka55: doesn't show hand 
*** SUMMARY ***
Total pot $0.27 | Rake $0.01 
Board [3d 2s As]
Seat 1: olegch3 (button) folded before Flop (didn't bet)
Seat 2: Mara6111 (small blind) folded before Flop
Seat 3: R D J 1965 (big blind) folded before Flop
Seat 4: tomashovka55 collected ($0.26)
Seat 5: murrie666 folded on the Flop
Seat 6: TrankTank folded before Flop (didn't bet)
Seat 7: pumpedli folded before Flop (didn't bet)
Seat 8: dorro61966 folded before Flop (didn't bet)
Seat 9: snow9001 folded on the Flop



PokerStars Zoom Hand #216383888276:  Hold'em No Limit ($0.01/$0.02) - 2020/07/13 19:52:07 CET [2020/07/13 13:52:07 ET]
Table 'McNaught' 9-max Seat #1 is the button
Seat 1: TrankTank ($3.99 in chips) 
Seat 2: hurla64 ($2.60 in chips) 
Seat 3: canxuh ($1.99 in chips) 
Seat 4: BONECA DELICADA ($1.44 in chips) 
Seat 5: Pentonomix ($1.01 in chips) 
Seat 6: Mizepa ($2.03 in chips) 
Seat 7: partizan_vlg ($0.90 in chips) 
Seat 8: BEUXA ($2.13 in chips) 
Seat 9: AdaiRu888 ($2.33 in chips) 
hurla64: posts small blind $0.01
canxuh: posts big blind $0.02
*** HOLE CARDS ***
Dealt to TrankTank [8d Ks]
BONECA DELICADA: folds 
Pentonomix: folds 
Mizepa: folds 
partizan_vlg: folds 
BEUXA: folds 
AdaiRu888: folds 
TrankTank: folds 
hurla64: folds 
Uncalled bet ($0.01) returned to canxuh
canxuh collected $0.02 from pot
canxuh: doesn't show hand 
*** SUMMARY ***
Total pot $0.02 | Rake $0 
Seat 1: TrankTank (button) folded before Flop (didn't bet)
Seat 2: hurla64 (small blind) folded before Flop
Seat 3: canxuh (big blind) collected ($0.02)
Seat 4: BONECA DELICADA folded before Flop (didn't bet)
Seat 5: Pentonomix folded before Flop (didn't bet)
Seat 6: Mizepa folded before Flop (didn't bet)
Seat 7: partizan_vlg folded before Flop (didn't bet)
Seat 8: BEUXA folded before Flop (didn't bet)
Seat 9: AdaiRu888 folded before Flop (didn't bet)



PokerStars Zoom Hand #216383901469:  Hold'em No Limit ($0.01/$0.02) - 2020/07/13 19:52:31 CET [2020/07/13 13:52:31 ET]
Table 'McNaught' 9-max Seat #1 is the button
Seat 1: TheBlade8525 ($4.36 in chips) 
Seat 2: BEUXA ($2.13 in chips) 
Seat 3: pumpedli ($2.84 in chips) 
Seat 4: snow9001 ($2.26 in chips) 
Seat 5: River_GmbH ($1.26 in chips) 
Seat 6: BadBeat Bert ($4.31 in chips) 
Seat 7: bogdan_k_ua ($2.40 in chips) 
Seat 8: TrankTank ($3.99 in chips) 
Seat 9: HAL VAGYOK ($2 in chips) 
BEUXA: posts small blind $0.01
pumpedli: posts big blind $0.02
*** HOLE CARDS ***
Dealt to TrankTank [9d 5h]
snow9001 has timed out
snow9001: folds 
River_GmbH: folds 
BadBeat Bert: folds 
bogdan_k_ua: folds 
TrankTank: folds 
HAL VAGYOK: folds 
TheBlade8525: folds 
BEUXA: folds 
Uncalled bet ($0.01) returned to pumpedli
pumpedli collected $0.02 from pot
pumpedli: doesn't show hand 
*** SUMMARY ***
Total pot $0.02 | Rake $0 
Seat 1: TheBlade8525 (button) folded before Flop (didn't bet)
Seat 2: BEUXA (small blind) folded before Flop
Seat 3: pumpedli (big blind) collected ($0.02)
Seat 4: snow9001 folded before Flop (didn't bet)
Seat 5: River_GmbH folded before Flop (didn't bet)
Seat 6: BadBeat Bert folded before Flop (didn't bet)
Seat 7: bogdan_k_ua folded before Flop (didn't bet)
Seat 8: TrankTank folded before Flop (didn't bet)
Seat 9: HAL VAGYOK folded before Flop (didn't bet)



PokerStars Zoom Hand #216383904213:  Hold'em No Limit ($0.01/$0.02) - 2020/07/13 19:52:36 CET [2020/07/13 13:52:36 ET]
Table 'McNaught' 9-max Seat #1 is the button
Seat 1: jackbam993 ($0.41 in chips) 
Seat 2: hurla64 ($1.99 in chips) 
Seat 3: cuzmich500 ($1.71 in chips) 
Seat 4: BEUXA ($2.12 in chips) 
Seat 5: Chev.de Mere ($1.25 in chips) 
Seat 6: River_GmbH ($1.26 in chips) 
Seat 7: TrankTank ($3.99 in chips) 
Seat 8: sczurek19681 ($2.44 in chips) 
Seat 9: partizan_vlg ($0.89 in chips) 
hurla64: posts small blind $0.01
cuzmich500: posts big blind $0.02
*** HOLE CARDS ***
Dealt to TrankTank [As Kh]
BEUXA: folds 
Chev.de Mere: folds 
River_GmbH: folds 
TrankTank: raises $0.04 to $0.06
sczurek19681: folds 
partizan_vlg: folds 
jackbam993: folds 
hurla64: folds 
cuzmich500: folds 
Uncalled bet ($0.04) returned to TrankTank
TrankTank collected $0.05 from pot
TrankTank: doesn't show hand 
*** SUMMARY ***
Total pot $0.05 | Rake $0 
Seat 1: jackbam993 (button) folded before Flop (didn't bet)
Seat 2: hurla64 (small blind) folded before Flop
Seat 3: cuzmich500 (big blind) folded before Flop
Seat 4: BEUXA folded before Flop (didn't bet)
Seat 5: Chev.de Mere folded before Flop (didn't bet)
Seat 6: River_GmbH folded before Flop (didn't bet)
Seat 7: TrankTank collected ($0.05)
Seat 8: sczurek19681 folded before Flop (didn't bet)
Seat 9: partizan_vlg folded before Flop (didn't bet)



PokerStars Zoom Hand #216383896976:  Hold'em No Limit ($0.01/$0.02) - 2020/07/13 19:52:23 CET [2020/07/13 13:52:23 ET]
Table 'McNaught' 9-max Seat #1 is the button
Seat 1: Akiwjuh ($1.18 in chips) 
Seat 2: Krimil ($0.88 in chips) 
Seat 3: sczurek19681 ($2.46 in chips) 
Seat 4: wraggy225 ($6.14 in chips) 
Seat 5: TrankTank ($3.99 in chips) 
Seat 6: snow9001 ($2.26 in chips) 
Seat 7: Skydomes ($2.90 in chips) 
Seat 8: cathousecat ($4.60 in chips) 
Seat 9: DobrodiySS ($1.50 in chips) 
Krimil: posts small blind $0.01
sczurek19681: posts big blind $0.02
*** HOLE CARDS ***
Dealt to TrankTank [2s Ac]
wraggy225: folds 
Akiwjuh is disconnected 
TrankTank: folds 
snow9001: folds 
Skydomes: raises $0.03 to $0.05
cathousecat: calls $0.05
DobrodiySS: folds 
Akiwjuh: folds 
Krimil: calls $0.04
sczurek19681: folds 
*** FLOP *** [4c 8d 5s]
Krimil: checks 
Skydomes: bets $0.08
cathousecat: calls $0.08
Krimil: raises $0.40 to $0.48
Skydomes: calls $0.40
cathousecat: folds 
*** TURN *** [4c 8d 5s] [Jd]
Krimil: bets $0.35 and is all-in
Skydomes: calls $0.35
*** RIVER *** [4c 8d 5s Jd] [2c]
*** SHOW DOWN ***
Krimil: shows [Td Ts] (a pair of Tens)
Skydomes: shows [Kh Kc] (a pair of Kings)
Skydomes cashed out the hand for $1.73 | Cash Out Fee $0.02
*** SUMMARY ***
Total pot $1.91 | Rake $0.07 
Board [4c 8d 5s Jd 2c]
Seat 1: Akiwjuh (button) folded before Flop (didn't bet)
Seat 2: Krimil (small blind) showed [Td Ts] and lost with a pair of Tens
Seat 3: sczurek19681 (big blind) folded before Flop
Seat 4: wraggy225 folded before Flop (didn't bet)
Seat 5: TrankTank folded before Flop (didn't bet)
Seat 6: snow9001 folded before Flop (didn't bet)
Seat 7: Skydomes showed [Kh Kc] and won ($1.84) with a pair of Kings (pot not awarded as player cashed out)
Seat 8: cathousecat folded on the Flop
Seat 9: DobrodiySS folded before Flop (didn't bet)



PokerStars Zoom Hand #216383917934:  Hold'em No Limit ($0.01/$0.02) - 2020/07/13 19:53:01 CET [2020/07/13 13:53:01 ET]
Table 'McNaught' 9-max Seat #1 is the button
Seat 1: sibay02rus ($2 in chips) 
Seat 2: ggGoldenPunk ($2.04 in chips) 
Seat 3: qtmm ($2.12 in chips) 
Seat 4: TrankTank ($4.02 in chips) 
Seat 5: sayatsemey ($2.05 in chips) 
Seat 6: snow9001 ($2 in chips) 
Seat 7: komodo75 ($2 in chips) 
Seat 8: dorro61966 ($3.32 in chips) 
Seat 9: hurla64 ($1.98 in chips) 
ggGoldenPunk: posts small blind $0.01
qtmm: posts big blind $0.02
*** HOLE CARDS ***
Dealt to TrankTank [Tc Td]
TrankTank: raises $0.04 to $0.06
sayatsemey: folds 
snow9001: folds 
komodo75: folds 
dorro61966: calls $0.06
hurla64: folds 
sibay02rus: calls $0.06
ggGoldenPunk: folds 
qtmm: folds 
*** FLOP *** [3s 7c Ah]
TrankTank: checks 
dorro61966: bets $0.02
sibay02rus: raises $0.12 to $0.14
TrankTank: folds 
dorro61966: calls $0.12
*** TURN *** [3s 7c Ah] [4s]
dorro61966: bets $0.02
sibay02rus: raises $0.16 to $0.18
dorro61966: calls $0.16
*** RIVER *** [3s 7c Ah 4s] [8s]
dorro61966: bets $0.02
sibay02rus: calls $0.02
*** SHOW DOWN ***
dorro61966: shows [Kh Ac] (a pair of Aces)
sibay02rus: shows [Kc Ad] (a pair of Aces)
dorro61966 collected $0.43 from pot
sibay02rus collected $0.43 from pot
*** SUMMARY ***
Total pot $0.89 | Rake $0.03 
Board [3s 7c Ah 4s 8s]
Seat 1: sibay02rus (button) showed [Kc Ad] and won ($0.43) with a pair of Aces
Seat 2: ggGoldenPunk (small blind) folded before Flop
Seat 3: qtmm (big blind) folded before Flop
Seat 4: TrankTank folded on the Flop
Seat 5: sayatsemey folded before Flop (didn't bet)
Seat 6: snow9001 folded before Flop (didn't bet)
Seat 7: komodo75 folded before Flop (didn't bet)
Seat 8: dorro61966 showed [Kh Ac] and won ($0.43) with a pair of Aces
Seat 9: hurla64 folded before Flop (didn't bet)



PokerStars Zoom Hand #216383942973:  Hold'em No Limit ($0.01/$0.02) - 2020/07/13 19:53:46 CET [2020/07/13 13:53:46 ET]
Table 'McNaught' 9-max Seat #1 is the button
Seat 1: dzhonijs_e ($2.57 in chips) 
Seat 2: Hese_8 ($1.65 in chips) 
Seat 3: pocoyo088 ($4.23 in chips) 
Seat 4: Brixx440 ($2.81 in chips) 
Seat 5: TrankTank ($3.96 in chips) 
Seat 6: KAMETA821 ($2.40 in chips) 
Seat 7: pellion ($2.03 in chips) 
Seat 8: Armtone ($1.97 in chips) 
Seat 9: Chev.de Mere ($1.16 in chips) 
Hese_8: posts small blind $0.01
pocoyo088: posts big blind $0.02
*** HOLE CARDS ***
Dealt to TrankTank [Kc Qh]
Brixx440: folds 
TrankTank: raises $0.04 to $0.06
KAMETA821: calls $0.06
pellion: folds 
Armtone: folds 
Chev.de Mere: folds 
dzhonijs_e: raises $0.14 to $0.20
Hese_8: folds 
pocoyo088: folds 
TrankTank: folds 
KAMETA821: calls $0.14
*** FLOP *** [6h 3d 4s]
KAMETA821: checks 
dzhonijs_e: bets $0.25
KAMETA821: calls $0.25
*** TURN *** [6h 3d 4s] [3c]
KAMETA821: checks 
dzhonijs_e: checks 
*** RIVER *** [6h 3d 4s 3c] [2d]
KAMETA821: bets $0.48
dzhonijs_e: folds 
Uncalled bet ($0.48) returned to KAMETA821
KAMETA821 collected $0.96 from pot
KAMETA821: doesn't show hand 
*** SUMMARY ***
Total pot $0.99 | Rake $0.03 
Board [6h 3d 4s 3c 2d]
Seat 1: dzhonijs_e (button) folded on the River
Seat 2: Hese_8 (small blind) folded before Flop
Seat 3: pocoyo088 (big blind) folded before Flop
Seat 4: Brixx440 folded before Flop (didn't bet)
Seat 5: TrankTank folded before Flop
Seat 6: KAMETA821 collected ($0.96)
Seat 7: pellion folded before Flop (didn't bet)
Seat 8: Armtone folded before Flop (didn't bet)
Seat 9: Chev.de Mere folded before Flop (didn't bet)



PokerStars Zoom Hand #216383958353:  Hold'em No Limit ($0.01/$0.02) - 2020/07/13 19:54:12 CET [2020/07/13 13:54:12 ET]
Table 'McNaught' 9-max Seat #1 is the button
Seat 1: ALF_70 ($1.52 in chips) 
Seat 2: ggGoldenPunk ($3.68 in chips) 
Seat 3: TrankTank ($3.90 in chips) 
Seat 4: avstero ($1.69 in chips) 
Seat 5: sibay02rus ($2 in chips) 
Seat 6: dorro61966 ($3.35 in chips) 
Seat 7: GaliRah ($2.12 in chips) 
Seat 8: Hese_8 ($1.64 in chips) 
Seat 9: Luisk2293 ($2 in chips) 
ggGoldenPunk: posts small blind $0.01
TrankTank: posts big blind $0.02
*** HOLE CARDS ***
Dealt to TrankTank [2c 7h]
avstero: folds 
sibay02rus: folds 
dorro61966: folds 
GaliRah: folds 
Hese_8: raises $0.02 to $0.04
Luisk2293: folds 
ALF_70: calls $0.04
ggGoldenPunk: folds 
TrankTank: folds 
*** FLOP *** [2d Tc 8s]
Hese_8: bets $0.03
ALF_70: calls $0.03
*** TURN *** [2d Tc 8s] [6h]
Hese_8: bets $0.07
ALF_70: folds 
Uncalled bet ($0.07) returned to Hese_8
Hese_8 collected $0.16 from pot
Hese_8: doesn't show hand 
*** SUMMARY ***
Total pot $0.17 | Rake $0.01 
Board [2d Tc 8s 6h]
Seat 1: ALF_70 (button) folded on the Turn
Seat 2: ggGoldenPunk (small blind) folded before Flop
Seat 3: TrankTank (big blind) folded before Flop
Seat 4: avstero folded before Flop (didn't bet)
Seat 5: sibay02rus folded before Flop (didn't bet)
Seat 6: dorro61966 folded before Flop (didn't bet)
Seat 7: GaliRah folded before Flop (didn't bet)
Seat 8: Hese_8 collected ($0.16)
Seat 9: Luisk2293 folded before Flop (didn't bet)



PokerStars Zoom Hand #216383967250:  Hold'em No Limit ($0.01/$0.02) - 2020/07/13 19:54:28 CET [2020/07/13 13:54:28 ET]
Table 'McNaught' 9-max Seat #1 is the button
Seat 1: RRigoletto ($2.36 in chips) 
Seat 2: HAL VAGYOK ($2.15 in chips) 
Seat 3: tomashovka55 ($3.18 in chips) 
Seat 4: xAndrzej-K ($6.34 in chips) 
Seat 5: hurla64 ($3.17 in chips) 
Seat 6: Luisk2293 ($2 in chips) 
Seat 7: sibay02rus ($2.03 in chips) 
Seat 8: TrankTank ($3.88 in chips) 
Seat 9: givinfree$ ($2 in chips) 
HAL VAGYOK: posts small blind $0.01
tomashovka55: posts big blind $0.02
*** HOLE CARDS ***
Dealt to TrankTank [8c Kd]
xAndrzej-K: folds 
hurla64: folds 
Luisk2293 has timed out
Luisk2293: folds 
sibay02rus: folds 
TrankTank: folds 
givinfree$: folds 
RRigoletto: folds 
HAL VAGYOK: raises $0.04 to $0.06
tomashovka55: folds 
Uncalled bet ($0.04) returned to HAL VAGYOK
HAL VAGYOK collected $0.04 from pot
HAL VAGYOK: doesn't show hand 
*** SUMMARY ***
Total pot $0.04 | Rake $0 
Seat 1: RRigoletto (button) folded before Flop (didn't bet)
Seat 2: HAL VAGYOK (small blind) collected ($0.04)
Seat 3: tomashovka55 (big blind) folded before Flop
Seat 4: xAndrzej-K folded before Flop (didn't bet)
Seat 5: hurla64 folded before Flop (didn't bet)
Seat 6: Luisk2293 folded before Flop (didn't bet)
Seat 7: sibay02rus folded before Flop (didn't bet)
Seat 8: TrankTank folded before Flop (didn't bet)
Seat 9: givinfree$ folded before Flop (didn't bet)



PokerStars Zoom Hand #216383978936:  Hold'em No Limit ($0.01/$0.02) - 2020/07/13 19:54:49 CET [2020/07/13 13:54:49 ET]
Table 'McNaught' 9-max Seat #1 is the button
Seat 1: TrankTank ($3.88 in chips) 
Seat 2: RyuInShadow ($2.23 in chips) 
Seat 3: SUPERNUNO ($2.25 in chips) 
Seat 4: Luisk2293 ($2 in chips) 
Seat 5: Emrama ($1.02 in chips) 
Seat 6: cuzmich500 ($1.68 in chips) 
Seat 7: Hese_8 ($1.73 in chips) 
Seat 8: wraggy225 ($4.57 in chips) 
Seat 9: dorro61966 ($3.33 in chips) 
RyuInShadow: posts small blind $0.01
SUPERNUNO: posts big blind $0.02
*** HOLE CARDS ***
Dealt to TrankTank [3s 2s]
Luisk2293: raises $0.03 to $0.05
Emrama: calls $0.05
cuzmich500: folds 
Hese_8: folds 
wraggy225: folds 
dorro61966: folds 
TrankTank: folds 
RyuInShadow: folds 
SUPERNUNO: calls $0.03
*** FLOP *** [3d Tc Jd]
SUPERNUNO: checks 
Luisk2293: bets $0.11
Emrama: folds 
SUPERNUNO: folds 
Uncalled bet ($0.11) returned to Luisk2293
Luisk2293 collected $0.15 from pot
Luisk2293: doesn't show hand 
*** SUMMARY ***
Total pot $0.16 | Rake $0.01 
Board [3d Tc Jd]
Seat 1: TrankTank (button) folded before Flop (didn't bet)
Seat 2: RyuInShadow (small blind) folded before Flop
Seat 3: SUPERNUNO (big blind) folded on the Flop
Seat 4: Luisk2293 collected ($0.15)
Seat 5: Emrama folded on the Flop
Seat 6: cuzmich500 folded before Flop (didn't bet)
Seat 7: Hese_8 folded before Flop (didn't bet)
Seat 8: wraggy225 folded before Flop (didn't bet)
Seat 9: dorro61966 folded before Flop (didn't bet)



PokerStars Zoom Hand #216383998918:  Hold'em No Limit ($0.01/$0.02) - 2020/07/13 19:55:31 CET [2020/07/13 13:55:31 ET]
Table 'McNaught' 9-max Seat #1 is the button
Seat 1: Auriel85 ($1.49 in chips) 
Seat 2: cathousecat ($3.68 in chips) 
Seat 3: red_81_2009 ($2.04 in chips) 
Seat 4: edeust ($2.09 in chips) 
Seat 5: pisqnek ($3.28 in chips) 
Seat 6: snow9001 ($2.10 in chips) 
Seat 7: tomashovka55 ($2 in chips) 
Seat 8: Iron208 ($2 in chips) 
Seat 9: TrankTank ($3.87 in chips) 
cathousecat: posts small blind $0.01
red_81_2009: posts big blind $0.02
*** HOLE CARDS ***
Dealt to TrankTank [8d 5h]
edeust: folds 
pisqnek: folds 
snow9001: raises $0.03 to $0.05
tomashovka55: folds 
Iron208: folds 
TrankTank: folds 
Auriel85: folds 
cathousecat: folds 
red_81_2009: folds 
Uncalled bet ($0.03) returned to snow9001
snow9001 collected $0.05 from pot
snow9001: doesn't show hand 
*** SUMMARY ***
Total pot $0.05 | Rake $0 
Seat 1: Auriel85 (button) folded before Flop (didn't bet)
Seat 2: cathousecat (small blind) folded before Flop
Seat 3: red_81_2009 (big blind) folded before Flop
Seat 4: edeust folded before Flop (didn't bet)
Seat 5: pisqnek folded before Flop (didn't bet)
Seat 6: snow9001 collected ($0.05)
Seat 7: tomashovka55 folded before Flop (didn't bet)
Seat 8: Iron208 folded before Flop (didn't bet)
Seat 9: TrankTank folded before Flop (didn't bet)



PokerStars Zoom Hand #216383985075:  Hold'em No Limit ($0.01/$0.02) - 2020/07/13 19:55:00 CET [2020/07/13 13:55:00 ET]
Table 'McNaught' 9-max Seat #1 is the button
Seat 1: EliFilho55 ($3.35 in chips) 
Seat 2: TrankTank ($3.88 in chips) 
Seat 3: 5gdangers ($11.10 in chips) 
Seat 4: BadBeat Bert ($4.26 in chips) 
Seat 5: pocoyo088 ($2.03 in chips) 
Seat 6: Gonhar55 ($1.77 in chips) 
Seat 7: partizan_vlg ($0.97 in chips) 
Seat 8: givinfree$ ($2.03 in chips) 
Seat 9: red_81_2009 ($1.97 in chips) 
TrankTank: posts small blind $0.01
5gdangers: posts big blind $0.02
*** HOLE CARDS ***
Dealt to TrankTank [5d 9c]
BadBeat Bert: folds 
pocoyo088: folds 
Gonhar55: raises $0.04 to $0.06
partizan_vlg: folds 
givinfree$: folds 
red_81_2009: folds 
EliFilho55: calls $0.06
TrankTank: folds 
5gdangers: calls $0.04
*** FLOP *** [Ts 9s Qs]
5gdangers: bets $0.09
Gonhar55: folds 
EliFilho55: calls $0.09
*** TURN *** [Ts 9s Qs] [3c]
5gdangers: bets $0.18
EliFilho55: calls $0.18
*** RIVER *** [Ts 9s Qs 3c] [7h]
5gdangers: checks 
EliFilho55: checks 
*** SHOW DOWN ***
5gdangers: shows [Qc Kh] (a pair of Queens)
EliFilho55: shows [Qd As] (a pair of Queens - Ace kicker)
EliFilho55 collected $0.70 from pot
*** SUMMARY ***
Total pot $0.73 | Rake $0.03 
Board [Ts 9s Qs 3c 7h]
Seat 1: EliFilho55 (button) showed [Qd As] and won ($0.70) with a pair of Queens
Seat 2: TrankTank (small blind) folded before Flop
Seat 3: 5gdangers (big blind) showed [Qc Kh] and lost with a pair of Queens
Seat 4: BadBeat Bert folded before Flop (didn't bet)
Seat 5: pocoyo088 folded before Flop (didn't bet)
Seat 6: Gonhar55 folded on the Flop
Seat 7: partizan_vlg folded before Flop (didn't bet)
Seat 8: givinfree$ folded before Flop (didn't bet)
Seat 9: red_81_2009 folded before Flop (didn't bet)



PokerStars Zoom Hand #216384006981:  Hold'em No Limit ($0.01/$0.02) - 2020/07/13 19:55:51 CET [2020/07/13 13:55:51 ET]
Table 'McNaught' 9-max Seat #1 is the button
Seat 1: ALF_70 ($1.38 in chips) 
Seat 2: FelixFerrari ($2.25 in chips) 
Seat 3: sayatsemey ($4.32 in chips) 
Seat 4: RRigoletto ($2.37 in chips) 
Seat 5: papatomi4 ($2.44 in chips) 
Seat 6: TrankTank ($3.87 in chips) 
Seat 7: snow9001 ($2.37 in chips) 
Seat 8: WilFred.ru ($1.84 in chips) 
Seat 9: hoss145 ($2.97 in chips) 
FelixFerrari: posts small blind $0.01
sayatsemey: posts big blind $0.02
*** HOLE CARDS ***
Dealt to TrankTank [8s 2c]
RRigoletto: folds 
papatomi4: folds 
TrankTank: folds 
snow9001: raises $0.03 to $0.05
WilFred.ru: folds 
hoss145: folds 
ALF_70: folds 
FelixFerrari: folds 
sayatsemey: folds 
Uncalled bet ($0.03) returned to snow9001
snow9001 collected $0.05 from pot
snow9001: doesn't show hand 
*** SUMMARY ***
Total pot $0.05 | Rake $0 
Seat 1: ALF_70 (button) folded before Flop (didn't bet)
Seat 2: FelixFerrari (small blind) folded before Flop
Seat 3: sayatsemey (big blind) folded before Flop
Seat 4: RRigoletto folded before Flop (didn't bet)
Seat 5: papatomi4 folded before Flop (didn't bet)
Seat 6: TrankTank folded before Flop (didn't bet)
Seat 7: snow9001 collected ($0.05)
Seat 8: WilFred.ru folded before Flop (didn't bet)
Seat 9: hoss145 folded before Flop (didn't bet)



PokerStars Zoom Hand #216384013011:  Hold'em No Limit ($0.01/$0.02) - 2020/07/13 19:56:06 CET [2020/07/13 13:56:06 ET]
Table 'McNaught' 9-max Seat #1 is the button
Seat 1: dori_vedimak ($1.83 in chips) 
Seat 2: hurla64 ($3.27 in chips) 
Seat 3: AdaiRu888 ($2.03 in chips) 
Seat 4: tomashovka55 ($2.03 in chips) 
Seat 5: pellion ($2.06 in chips) 
Seat 6: Ronvangen ($0.91 in chips) 
Seat 7: TrankTank ($3.87 in chips) 
Seat 8: hoss145 ($2.96 in chips) 
Seat 9: FelixFerrari ($2.24 in chips) 
hurla64: posts small blind $0.01
AdaiRu888: posts big blind $0.02
*** HOLE CARDS ***
Dealt to TrankTank [Qc 5s]
tomashovka55: raises $0.04 to $0.06
pellion: folds 
Ronvangen: folds 
TrankTank: folds 
hoss145: calls $0.06
FelixFerrari: folds 
dori_vedimak: calls $0.06
hurla64: folds 
AdaiRu888: folds 
*** FLOP *** [Ts 6c 4c]
tomashovka55: bets $0.11
hoss145: folds 
dori_vedimak: folds 
Uncalled bet ($0.11) returned to tomashovka55
tomashovka55 collected $0.20 from pot
tomashovka55: doesn't show hand 
*** SUMMARY ***
Total pot $0.21 | Rake $0.01 
Board [Ts 6c 4c]
Seat 1: dori_vedimak (button) folded on the Flop
Seat 2: hurla64 (small blind) folded before Flop
Seat 3: AdaiRu888 (big blind) folded before Flop
Seat 4: tomashovka55 collected ($0.20)
Seat 5: pellion folded before Flop (didn't bet)
Seat 6: Ronvangen folded before Flop (didn't bet)
Seat 7: TrankTank folded before Flop (didn't bet)
Seat 8: hoss145 folded on the Flop
Seat 9: FelixFerrari folded before Flop (didn't bet)



PokerStars Zoom Hand #216384017065:  Hold'em No Limit ($0.01/$0.02) - 2020/07/13 19:56:16 CET [2020/07/13 13:56:16 ET]
Table 'McNaught' 9-max Seat #1 is the button
Seat 1: niko16321 ($2.18 in chips) 
Seat 2: ALF_70 ($1.38 in chips) 
Seat 3: ChilyNoir ($1.34 in chips) 
Seat 4: WilFred.ru ($1.84 in chips) 
Seat 5: TrankTank ($3.87 in chips) 
Seat 6: pocoyo088 ($2 in chips) 
Seat 7: cuzmich500 ($3.51 in chips) 
Seat 8: snow9001 ($2.54 in chips) 
Seat 9: Iron208 ($2 in chips) 
ALF_70: posts small blind $0.01
ChilyNoir: posts big blind $0.02
*** HOLE CARDS ***
Dealt to TrankTank [9d 8d]
WilFred.ru: folds 
TrankTank: folds 
pocoyo088: folds 
cuzmich500: folds 
snow9001: folds 
Iron208: raises $0.03 to $0.05
niko16321: folds 
ALF_70: folds 
ChilyNoir: calls $0.03
*** FLOP *** [Jc 3c Ac]
ChilyNoir: checks 
Iron208: bets $0.06
ChilyNoir: calls $0.06
*** TURN *** [Jc 3c Ac] [4h]
ChilyNoir: checks 
Iron208: bets $0.16
ChilyNoir: raises $0.27 to $0.43
Iron208: calls $0.27
*** RIVER *** [Jc 3c Ac 4h] [Kh]
ChilyNoir: bets $0.80 and is all-in
Iron208: calls $0.80
*** SHOW DOWN ***
ChilyNoir: shows [6c 4c] (a flush, Ace high)
Iron208: shows [Ad Kc] (two pair, Aces and Kings)
ChilyNoir collected $2.60 from pot
*** SUMMARY ***
Total pot $2.69 | Rake $0.09 
Board [Jc 3c Ac 4h Kh]
Seat 1: niko16321 (button) folded before Flop (didn't bet)
Seat 2: ALF_70 (small blind) folded before Flop
Seat 3: ChilyNoir (big blind) showed [6c 4c] and won ($2.60) with a flush, Ace high
Seat 4: WilFred.ru folded before Flop (didn't bet)
Seat 5: TrankTank folded before Flop (didn't bet)
Seat 6: pocoyo088 folded before Flop (didn't bet)
Seat 7: cuzmich500 folded before Flop (didn't bet)
Seat 8: snow9001 folded before Flop (didn't bet)
Seat 9: Iron208 showed [Ad Kc] and lost with two pair, Aces and Kings



PokerStars Zoom Hand #216384022831:  Hold'em No Limit ($0.01/$0.02) - 2020/07/13 19:56:30 CET [2020/07/13 13:56:30 ET]
Table 'McNaught' 9-max Seat #1 is the button
Seat 1: Djig1t ($2 in chips) 
Seat 2: ggGoldenPunk ($4.07 in chips) 
Seat 3: Alla Goa ($1.08 in chips) 
Seat 4: asvdm84 ($2.26 in chips) 
Seat 5: TrankTank ($3.87 in chips) 
Seat 6: pumpedli ($2 in chips) 
Seat 7: dori_vedimak ($1.47 in chips) 
Seat 8: j4man2000 ($1.26 in chips) 
Seat 9: hoss145 ($2 in chips) 
ggGoldenPunk: posts small blind $0.01
Alla Goa: posts big blind $0.02
*** HOLE CARDS ***
Dealt to TrankTank [As Ah]
asvdm84: folds 
TrankTank: raises $0.04 to $0.06
pumpedli: folds 
dori_vedimak: folds 
j4man2000: calls $0.06
hoss145: calls $0.06
Djig1t: folds 
ggGoldenPunk: folds 
Alla Goa: folds 
*** FLOP *** [Th 6d Jc]
TrankTank: bets $0.14
j4man2000: calls $0.14
hoss145: calls $0.14
*** TURN *** [Th 6d Jc] [9d]
TrankTank: bets $0.43
j4man2000: folds 
j4man2000 is disconnected 
hoss145: calls $0.43
*** RIVER *** [Th 6d Jc 9d] [3h]
TrankTank: bets $3.24 and is all-in
hoss145: folds 
Uncalled bet ($3.24) returned to TrankTank
TrankTank collected $1.44 from pot
TrankTank: doesn't show hand 
*** SUMMARY ***
Total pot $1.49 | Rake $0.05 
Board [Th 6d Jc 9d 3h]
Seat 1: Djig1t (button) folded before Flop (didn't bet)
Seat 2: ggGoldenPunk (small blind) folded before Flop
Seat 3: Alla Goa (big blind) folded before Flop
Seat 4: asvdm84 folded before Flop (didn't bet)
Seat 5: TrankTank collected ($1.44)
Seat 6: pumpedli folded before Flop (didn't bet)
Seat 7: dori_vedimak folded before Flop (didn't bet)
Seat 8: j4man2000 folded on the Turn
Seat 9: hoss145 folded on the River



PokerStars Zoom Hand #216384048107:  Hold'em No Limit ($0.01/$0.02) - 2020/07/13 19:57:32 CET [2020/07/13 13:57:32 ET]
Table 'McNaught' 9-max Seat #1 is the button
Seat 1: Akiwjuh ($0.26 in chips) 
Seat 2: Hese_8 ($1.01 in chips) 
Seat 3: TrankTank ($4.68 in chips) 
Seat 4: asvdm84 ($2.61 in chips) 
Seat 5: edeust ($2.15 in chips) 
Seat 6: sayatsemey ($1.87 in chips) 
Seat 7: Djig1t ($2 in chips) 
Seat 8: AdaiRu888 ($2.86 in chips) 
Seat 9: AniArun ($2.68 in chips) 
Hese_8: posts small blind $0.01
TrankTank: posts big blind $0.02
*** HOLE CARDS ***
Dealt to TrankTank [3s Jc]
Akiwjuh is disconnected 
asvdm84: calls $0.02
edeust: folds 
sayatsemey: raises $0.04 to $0.06
Djig1t: folds 
AdaiRu888: folds 
AniArun: folds 
Akiwjuh: folds 
Hese_8: folds 
TrankTank: folds 
asvdm84: calls $0.04
*** FLOP *** [Kc 9d Tc]
asvdm84: checks 
sayatsemey: bets $0.12
asvdm84: folds 
Uncalled bet ($0.12) returned to sayatsemey
sayatsemey collected $0.14 from pot
sayatsemey: doesn't show hand 
*** SUMMARY ***
Total pot $0.15 | Rake $0.01 
Board [Kc 9d Tc]
Seat 1: Akiwjuh (button) folded before Flop (didn't bet)
Seat 2: Hese_8 (small blind) folded before Flop
Seat 3: TrankTank (big blind) folded before Flop
Seat 4: asvdm84 folded on the Flop
Seat 5: edeust folded before Flop (didn't bet)
Seat 6: sayatsemey collected ($0.14)
Seat 7: Djig1t folded before Flop (didn't bet)
Seat 8: AdaiRu888 folded before Flop (didn't bet)
Seat 9: AniArun folded before Flop (didn't bet)



PokerStars Zoom Hand #216384066297:  Hold'em No Limit ($0.01/$0.02) - 2020/07/13 19:57:54 CET [2020/07/13 13:57:54 ET]
Table 'McNaught' 9-max Seat #1 is the button
Seat 1: givinfree$ ($2.65 in chips) 
Seat 2: red_81_2009 ($1.97 in chips) 
Seat 3: STYNG01 ($17.60 in chips) 
Seat 4: tomashovka55 ($3.01 in chips) 
Seat 5: jonick17 ($0.73 in chips) 
Seat 6: TrankTank ($4.66 in chips) 
Seat 7: Luisk2293 ($2.12 in chips) 
Seat 8: sayatsemey ($4.88 in chips) 
Seat 9: BONECA DELICADA ($1.79 in chips) 
red_81_2009: posts small blind $0.01
STYNG01: posts big blind $0.02
*** HOLE CARDS ***
Dealt to TrankTank [Js Qh]
tomashovka55: folds 
jonick17: folds 
TrankTank: raises $0.04 to $0.06
Luisk2293 has timed out
Luisk2293: folds 
sayatsemey: folds 
BONECA DELICADA: folds 
givinfree$: folds 
red_81_2009: folds 
STYNG01: folds 
Uncalled bet ($0.04) returned to TrankTank
TrankTank collected $0.05 from pot
TrankTank: doesn't show hand 
*** SUMMARY ***
Total pot $0.05 | Rake $0 
Seat 1: givinfree$ (button) folded before Flop (didn't bet)
Seat 2: red_81_2009 (small blind) folded before Flop
Seat 3: STYNG01 (big blind) folded before Flop
Seat 4: tomashovka55 folded before Flop (didn't bet)
Seat 5: jonick17 folded before Flop (didn't bet)
Seat 6: TrankTank collected ($0.05)
Seat 7: Luisk2293 folded before Flop (didn't bet)
Seat 8: sayatsemey folded before Flop (didn't bet)
Seat 9: BONECA DELICADA folded before Flop (didn't bet)



PokerStars Zoom Hand #216384076886:  Hold'em No Limit ($0.01/$0.02) - 2020/07/13 19:58:20 CET [2020/07/13 13:58:20 ET]
Table 'McNaught' 9-max Seat #1 is the button
Seat 1: TrankTank ($4.69 in chips) 
Seat 2: pocoyo088 ($2 in chips) 
Seat 3: XHerrTUMNUSX ($2 in chips) 
Seat 4: papatomi4 ($2.49 in chips) 
Seat 5: cuzmich500 ($2.15 in chips) 
Seat 6: weiting777 ($2.09 in chips) 
Seat 7: boduaco ($2 in chips) 
Seat 8: EliFilho55 ($3.61 in chips) 
Seat 9: niko16321 ($2.13 in chips) 
pocoyo088: posts small blind $0.01
XHerrTUMNUSX: posts big blind $0.02
*** HOLE CARDS ***
Dealt to TrankTank [6d 7d]
papatomi4: folds 
cuzmich500: folds 
weiting777: folds 
boduaco: folds 
EliFilho55: folds 
niko16321: folds 
TrankTank: folds 
pocoyo088: folds 
Uncalled bet ($0.01) returned to XHerrTUMNUSX
XHerrTUMNUSX collected $0.02 from pot
XHerrTUMNUSX: doesn't show hand 
*** SUMMARY ***
Total pot $0.02 | Rake $0 
Seat 1: TrankTank (button) folded before Flop (didn't bet)
Seat 2: pocoyo088 (small blind) folded before Flop
Seat 3: XHerrTUMNUSX (big blind) collected ($0.02)
Seat 4: papatomi4 folded before Flop (didn't bet)
Seat 5: cuzmich500 folded before Flop (didn't bet)
Seat 6: weiting777 folded before Flop (didn't bet)
Seat 7: boduaco folded before Flop (didn't bet)
Seat 8: EliFilho55 folded before Flop (didn't bet)
Seat 9: niko16321 folded before Flop (didn't bet)



PokerStars Zoom Hand #216384083916:  Hold'em No Limit ($0.01/$0.02) - 2020/07/13 19:58:37 CET [2020/07/13 13:58:37 ET]
Table 'McNaught' 9-max Seat #1 is the button
Seat 1: Sarahi P. ($1.76 in chips) 
Seat 2: TrankTank ($4.69 in chips) 
Seat 3: tomashovka55 ($2.19 in chips) 
Seat 4: Akiwjuh ($0.29 in chips) 
Seat 5: wraggy225 ($4.61 in chips) 
Seat 6: BONECA DELICADA ($1.79 in chips) 
Seat 7: sibay02rus ($2 in chips) 
Seat 8: hurla64 ($3.12 in chips) 
Seat 9: red_81_2009 ($1.91 in chips) 
TrankTank: posts small blind $0.01
tomashovka55: posts big blind $0.02
*** HOLE CARDS ***
Dealt to TrankTank [2h Th]
Akiwjuh: folds 
Akiwjuh is disconnected 
wraggy225: folds 
BONECA DELICADA: folds 
sibay02rus: folds 
hurla64: folds 
red_81_2009: folds 
Sarahi P.: folds 
TrankTank: folds 
Uncalled bet ($0.01) returned to tomashovka55
tomashovka55 collected $0.02 from pot
tomashovka55: doesn't show hand 
*** SUMMARY ***
Total pot $0.02 | Rake $0 
Seat 1: Sarahi P. (button) folded before Flop (didn't bet)
Seat 2: TrankTank (small blind) folded before Flop
Seat 3: tomashovka55 (big blind) collected ($0.02)
Seat 4: Akiwjuh folded before Flop (didn't bet)
Seat 5: wraggy225 folded before Flop (didn't bet)
Seat 6: BONECA DELICADA folded before Flop (didn't bet)
Seat 7: sibay02rus folded before Flop (didn't bet)
Seat 8: hurla64 folded before Flop (didn't bet)
Seat 9: red_81_2009 folded before Flop (didn't bet)



PokerStars Zoom Hand #216384087114:  Hold'em No Limit ($0.01/$0.02) - 2020/07/13 19:58:45 CET [2020/07/13 13:58:45 ET]
Table 'McNaught' 9-max Seat #1 is the button
Seat 1: Djig1t ($2 in chips) 
Seat 2: hurla64 ($4.16 in chips) 
Seat 3: pellion ($6.96 in chips) 
Seat 4: STYNG01 ($17.57 in chips) 
Seat 5: asvdm84 ($2.17 in chips) 
Seat 6: dori_vedimak ($1.98 in chips) 
Seat 7: SUPERNUNO ($3.25 in chips) 
Seat 8: snow9001 ($2.48 in chips) 
Seat 9: TrankTank ($4.68 in chips) 
hurla64: posts small blind $0.01
pellion: posts big blind $0.02
*** HOLE CARDS ***
Dealt to TrankTank [8d Qh]
STYNG01: folds 
asvdm84: raises $0.04 to $0.06
dori_vedimak: folds 
SUPERNUNO: folds 
snow9001: folds 
TrankTank: folds 
Djig1t: folds 
hurla64: folds 
pellion: folds 
Uncalled bet ($0.04) returned to asvdm84
asvdm84 collected $0.05 from pot
asvdm84: doesn't show hand 
*** SUMMARY ***
Total pot $0.05 | Rake $0 
Seat 1: Djig1t (button) folded before Flop (didn't bet)
Seat 2: hurla64 (small blind) folded before Flop
Seat 3: pellion (big blind) folded before Flop
Seat 4: STYNG01 folded before Flop (didn't bet)
Seat 5: asvdm84 collected ($0.05)
Seat 6: dori_vedimak folded before Flop (didn't bet)
Seat 7: SUPERNUNO folded before Flop (didn't bet)
Seat 8: snow9001 folded before Flop (didn't bet)
Seat 9: TrankTank folded before Flop (didn't bet)



PokerStars Zoom Hand #216384090781:  Hold'em No Limit ($0.01/$0.02) - 2020/07/13 19:58:54 CET [2020/07/13 13:58:54 ET]
Table 'McNaught' 9-max Seat #1 is the button
Seat 1: papatomi4 ($2.50 in chips) 
Seat 2: sibay02rus ($2 in chips) 
Seat 3: EliFilho55 ($3.61 in chips) 
Seat 4: hurla64 ($13.26 in chips) 
Seat 5: pellion ($2.28 in chips) 
Seat 6: red_81_2009 ($1.89 in chips) 
Seat 7: olegch3 ($1.82 in chips) 
Seat 8: TrankTank ($4.68 in chips) 
Seat 9: niko16321 ($2.13 in chips) 
sibay02rus: posts small blind $0.01
EliFilho55: posts big blind $0.02
*** HOLE CARDS ***
Dealt to TrankTank [5h Ts]
hurla64: raises $0.06 to $0.08
pellion: folds 
red_81_2009: folds 
olegch3: folds 
TrankTank: folds 
niko16321: folds 
papatomi4: calls $0.08
sibay02rus: folds 
EliFilho55: calls $0.06
*** FLOP *** [7d 3h Jd]
EliFilho55: checks 
hurla64: bets $0.13
papatomi4: raises $0.50 to $0.63
EliFilho55: folds 
hurla64: folds 
Uncalled bet ($0.50) returned to papatomi4
papatomi4 collected $0.49 from pot
papatomi4: doesn't show hand 
*** SUMMARY ***
Total pot $0.51 | Rake $0.02 
Board [7d 3h Jd]
Seat 1: papatomi4 (button) collected ($0.49)
Seat 2: sibay02rus (small blind) folded before Flop
Seat 3: EliFilho55 (big blind) folded on the Flop
Seat 4: hurla64 folded on the Flop
Seat 5: pellion folded before Flop (didn't bet)
Seat 6: red_81_2009 folded before Flop (didn't bet)
Seat 7: olegch3 folded before Flop (didn't bet)
Seat 8: TrankTank folded before Flop (didn't bet)
Seat 9: niko16321 folded before Flop (didn't bet)



PokerStars Zoom Hand #216384095381:  Hold'em No Limit ($0.01/$0.02) - 2020/07/13 19:59:05 CET [2020/07/13 13:59:05 ET]
Table 'McNaught' 9-max Seat #1 is the button
Seat 1: BerenKamlost ($2.22 in chips) 
Seat 2: pellion ($2.06 in chips) 
Seat 3: givinfree$ ($2.64 in chips) 
Seat 4: Iron208 ($2.01 in chips) 
Seat 5: ChilyNoir ($2.96 in chips) 
Seat 6: cathousecat ($3.06 in chips) 
Seat 7: TrankTank ($4.68 in chips) 
Seat 8: hurla64 ($4.15 in chips) 
Seat 9: ALF_70 ($1.99 in chips) 
pellion: posts small blind $0.01
givinfree$: posts big blind $0.02
*** HOLE CARDS ***
Dealt to TrankTank [Ah Kc]
Iron208: folds 
ChilyNoir: raises $0.06 to $0.08
cathousecat: folds 
TrankTank: raises $0.13 to $0.21
hurla64: folds 
ALF_70: folds 
BerenKamlost: folds 
pellion: folds 
givinfree$: folds 
ChilyNoir: calls $0.13
*** FLOP *** [7d 9s 7c]
ChilyNoir: checks 
TrankTank: bets $0.30
ChilyNoir: folds 
Uncalled bet ($0.30) returned to TrankTank
TrankTank collected $0.43 from pot
TrankTank: doesn't show hand 
*** SUMMARY ***
Total pot $0.45 | Rake $0.02 
Board [7d 9s 7c]
Seat 1: BerenKamlost (button) folded before Flop (didn't bet)
Seat 2: pellion (small blind) folded before Flop
Seat 3: givinfree$ (big blind) folded before Flop
Seat 4: Iron208 folded before Flop (didn't bet)
Seat 5: ChilyNoir folded on the Flop
Seat 6: cathousecat folded before Flop (didn't bet)
Seat 7: TrankTank collected ($0.43)
Seat 8: hurla64 folded before Flop (didn't bet)
Seat 9: ALF_70 folded before Flop (didn't bet)



PokerStars Zoom Hand #216384112606:  Hold'em No Limit ($0.01/$0.02) - 2020/07/13 19:59:47 CET [2020/07/13 13:59:47 ET]
Table 'McNaught' 9-max Seat #1 is the button
Seat 1: FelixFerrari ($2.23 in chips) 
Seat 2: mathplayer ($1.97 in chips) 
Seat 3: AdaiRu888 ($2.39 in chips) 
Seat 4: TrankTank ($4.90 in chips) 
Seat 5: Sarahi P. ($1.92 in chips) 
Seat 6: Iron208 ($2 in chips) 
Seat 7: pumpedli ($4.83 in chips) 
Seat 8: partizan_vlg ($1.35 in chips) 
Seat 9: givinfree$ ($2.20 in chips) 
mathplayer: posts small blind $0.01
AdaiRu888: posts big blind $0.02
*** HOLE CARDS ***
Dealt to TrankTank [Js 8d]
TrankTank: folds 
Sarahi P.: folds 
Iron208: folds 
pumpedli: folds 
partizan_vlg: folds 
givinfree$: folds 
FelixFerrari: folds 
mathplayer: folds 
Uncalled bet ($0.01) returned to AdaiRu888
AdaiRu888 collected $0.02 from pot
AdaiRu888: doesn't show hand 
*** SUMMARY ***
Total pot $0.02 | Rake $0 
Seat 1: FelixFerrari (button) folded before Flop (didn't bet)
Seat 2: mathplayer (small blind) folded before Flop
Seat 3: AdaiRu888 (big blind) collected ($0.02)
Seat 4: TrankTank folded before Flop (didn't bet)
Seat 5: Sarahi P. folded before Flop (didn't bet)
Seat 6: Iron208 folded before Flop (didn't bet)
Seat 7: pumpedli folded before Flop (didn't bet)
Seat 8: partizan_vlg folded before Flop (didn't bet)
Seat 9: givinfree$ folded before Flop (didn't bet)



PokerStars Zoom Hand #216384114621:  Hold'em No Limit ($0.01/$0.02) - 2020/07/13 19:59:52 CET [2020/07/13 13:59:52 ET]
Table 'McNaught' 9-max Seat #1 is the button
Seat 1: weiting777 ($1.35 in chips) 
Seat 2: XHerrTUMNUSX ($2 in chips) 
Seat 3: olegch3 ($1.97 in chips) 
Seat 4: joehlavicka ($2.85 in chips) 
Seat 5: Brixx440 ($2.59 in chips) 
Seat 6: TrankTank ($4.90 in chips) 
Seat 7: VARVAR92 ($2.63 in chips) 
Seat 8: dori_vedimak ($3.12 in chips) 
Seat 9: Tiggu ($3.19 in chips) 
XHerrTUMNUSX: posts small blind $0.01
olegch3: posts big blind $0.02
*** HOLE CARDS ***
Dealt to TrankTank [Jh 8s]
joehlavicka: folds 
Brixx440: folds 
TrankTank: folds 
VARVAR92: raises $0.04 to $0.06
dori_vedimak: folds 
Tiggu: calls $0.06
weiting777: folds 
XHerrTUMNUSX: folds 
olegch3: folds 
*** FLOP *** [2d Qs 5d]
VARVAR92: bets $0.07
Tiggu: folds 
Uncalled bet ($0.07) returned to VARVAR92
VARVAR92 collected $0.14 from pot
VARVAR92: doesn't show hand 
*** SUMMARY ***
Total pot $0.15 | Rake $0.01 
Board [2d Qs 5d]
Seat 1: weiting777 (button) folded before Flop (didn't bet)
Seat 2: XHerrTUMNUSX (small blind) folded before Flop
Seat 3: olegch3 (big blind) folded before Flop
Seat 4: joehlavicka folded before Flop (didn't bet)
Seat 5: Brixx440 folded before Flop (didn't bet)
Seat 6: TrankTank folded before Flop (didn't bet)
Seat 7: VARVAR92 collected ($0.14)
Seat 8: dori_vedimak folded before Flop (didn't bet)
Seat 9: Tiggu folded on the Flop



PokerStars Zoom Hand #216384117521:  Hold'em No Limit ($0.01/$0.02) - 2020/07/13 19:59:59 CET [2020/07/13 13:59:59 ET]
Table 'McNaught' 9-max Seat #1 is the button
Seat 1: wraggy225 ($5.42 in chips) 
Seat 2: pumpedli ($4.83 in chips) 
Seat 3: TrankTank ($4.90 in chips) 
Seat 4: WilFred.ru ($1.48 in chips) 
Seat 5: red_81_2009 ($1.92 in chips) 
Seat 6: BEUXA ($2.62 in chips) 
Seat 7: FelixFerrari ($2.23 in chips) 
Seat 8: pellion ($2.05 in chips) 
Seat 9: hurla64 ($3.12 in chips) 
pumpedli: posts small blind $0.01
TrankTank: posts big blind $0.02
*** HOLE CARDS ***
Dealt to TrankTank [4c 6h]
WilFred.ru: calls $0.02
red_81_2009: folds 
BEUXA: folds 
FelixFerrari: raises $0.07 to $0.09
pellion: folds 
hurla64: folds 
wraggy225: folds 
pumpedli: folds 
TrankTank: folds 
WilFred.ru: calls $0.07
*** FLOP *** [Jh 5s Jd]
WilFred.ru: bets $0.02
FelixFerrari: calls $0.02
*** TURN *** [Jh 5s Jd] [3s]
WilFred.ru: bets $0.02
FelixFerrari: calls $0.02
*** RIVER *** [Jh 5s Jd 3s] [4d]
WilFred.ru: bets $0.28
FelixFerrari: folds 
Uncalled bet ($0.28) returned to WilFred.ru
WilFred.ru collected $0.28 from pot
WilFred.ru: doesn't show hand 
*** SUMMARY ***
Total pot $0.29 | Rake $0.01 
Board [Jh 5s Jd 3s 4d]
Seat 1: wraggy225 (button) folded before Flop (didn't bet)
Seat 2: pumpedli (small blind) folded before Flop
Seat 3: TrankTank (big blind) folded before Flop
Seat 4: WilFred.ru collected ($0.28)
Seat 5: red_81_2009 folded before Flop (didn't bet)
Seat 6: BEUXA folded before Flop (didn't bet)
Seat 7: FelixFerrari folded on the River
Seat 8: pellion folded before Flop (didn't bet)
Seat 9: hurla64 folded before Flop (didn't bet)



PokerStars Zoom Hand #216384125249:  Hold'em No Limit ($0.01/$0.02) - 2020/07/13 20:00:15 CET [2020/07/13 14:00:15 ET]
Table 'McNaught' 9-max Seat #1 is the button
Seat 1: bogdan_k_ua ($1.81 in chips) 
Seat 2: sayatsemey ($4.89 in chips) 
Seat 3: tomashovka55 ($2.95 in chips) 
Seat 4: joehlavicka ($2.05 in chips) 
Seat 5: Djig1t ($2 in chips) 
Seat 6: pumpedli ($4.82 in chips) 
Seat 7: Iron208 ($2 in chips) 
Seat 8: TrankTank ($4.88 in chips) 
Seat 9: vasyara26 ($4.46 in chips) 
sayatsemey: posts small blind $0.01
tomashovka55: posts big blind $0.02
*** HOLE CARDS ***
Dealt to TrankTank [Ah 3d]
joehlavicka: folds 
Djig1t: folds 
pumpedli: folds 
Iron208: raises $0.03 to $0.05
TrankTank: folds 
vasyara26: calls $0.05
bogdan_k_ua: folds 
sayatsemey: folds 
tomashovka55: folds 
*** FLOP *** [4s 8c Td]
Iron208: checks 
vasyara26: bets $0.06
Iron208: folds 
Uncalled bet ($0.06) returned to vasyara26
vasyara26 collected $0.13 from pot
vasyara26: doesn't show hand 
*** SUMMARY ***
Total pot $0.13 | Rake $0 
Board [4s 8c Td]
Seat 1: bogdan_k_ua (button) folded before Flop (didn't bet)
Seat 2: sayatsemey (small blind) folded before Flop
Seat 3: tomashovka55 (big blind) folded before Flop
Seat 4: joehlavicka folded before Flop (didn't bet)
Seat 5: Djig1t folded before Flop (didn't bet)
Seat 6: pumpedli folded before Flop (didn't bet)
Seat 7: Iron208 folded on the Flop
Seat 8: TrankTank folded before Flop (didn't bet)
Seat 9: vasyara26 collected ($0.13)



PokerStars Zoom Hand #216384128700:  Hold'em No Limit ($0.01/$0.02) - 2020/07/13 20:00:23 CET [2020/07/13 14:00:23 ET]
Table 'McNaught' 9-max Seat #1 is the button
Seat 1: asvdm84 ($2.03 in chips) 
Seat 2: TrankTank ($4.88 in chips) 
Seat 3: TheBlade8525 ($3.69 in chips) 
Seat 4: pellion ($2.33 in chips) 
Seat 5: givinfree$ ($2.61 in chips) 
Seat 6: Mizepa ($2.11 in chips) 
Seat 7: wraggy225 ($3.87 in chips) 
Seat 8: hurla64 ($3.12 in chips) 
Seat 9: Armtone ($2.36 in chips) 
TrankTank: posts small blind $0.01
TheBlade8525: posts big blind $0.02
*** HOLE CARDS ***
Dealt to TrankTank [9d As]
pellion: folds 
givinfree$: folds 
Mizepa: folds 
wraggy225: folds 
hurla64: folds 
Armtone: folds 
asvdm84: calls $0.02
TrankTank: folds 
TheBlade8525: raises $0.08 to $0.10
asvdm84: folds 
Uncalled bet ($0.08) returned to TheBlade8525
TheBlade8525 collected $0.05 from pot
TheBlade8525: doesn't show hand 
*** SUMMARY ***
Total pot $0.05 | Rake $0 
Seat 1: asvdm84 (button) folded before Flop
Seat 2: TrankTank (small blind) folded before Flop
Seat 3: TheBlade8525 (big blind) collected ($0.05)
Seat 4: pellion folded before Flop (didn't bet)
Seat 5: givinfree$ folded before Flop (didn't bet)
Seat 6: Mizepa folded before Flop (didn't bet)
Seat 7: wraggy225 folded before Flop (didn't bet)
Seat 8: hurla64 folded before Flop (didn't bet)
Seat 9: Armtone folded before Flop (didn't bet)



PokerStars Zoom Hand #216384138916:  Hold'em No Limit ($0.01/$0.02) - 2020/07/13 20:00:46 CET [2020/07/13 14:00:46 ET]
Table 'McNaught' 9-max Seat #1 is the button
Seat 1: airamb.33 ($1 in chips) 
Seat 2: Alla Goa ($0.97 in chips) 
Seat 3: pumpedli ($3.08 in chips) 
Seat 4: TrankTank ($4.87 in chips) 
Seat 5: partizan_vlg ($1.29 in chips) 
Seat 6: HAL VAGYOK ($4.54 in chips) 
Seat 7: Mizepa ($2.11 in chips) 
Seat 8: Emrama ($0.82 in chips) 
Seat 9: murrie666 ($2.07 in chips) 
Alla Goa: posts small blind $0.01
pumpedli: posts big blind $0.02
*** HOLE CARDS ***
Dealt to TrankTank [2d 4s]
TrankTank: folds 
partizan_vlg: raises $1.27 to $1.29 and is all-in
HAL VAGYOK: folds 
Mizepa: folds 
Emrama: folds 
murrie666: folds 
airamb.33: folds 
Alla Goa: calls $0.96 and is all-in
pumpedli: folds 
Uncalled bet ($0.32) returned to partizan_vlg
*** FLOP *** [2c 7h Jh]
*** TURN *** [2c 7h Jh] [9c]
*** RIVER *** [2c 7h Jh 9c] [5d]
*** SHOW DOWN ***
Alla Goa: shows [Kh Ac] (high card Ace)
partizan_vlg: shows [Ad Ks] (high card Ace)
Alla Goa cashed out the hand for $0.94 | Cash Out Fee $0.01
partizan_vlg cashed out the hand for $0.93 | Cash Out Fee $0.01
*** SUMMARY ***
Total pot $1.96 | Rake $0.07 
Board [2c 7h Jh 9c 5d]
Seat 1: airamb.33 (button) folded before Flop (didn't bet)
Seat 2: Alla Goa (small blind) showed [Kh Ac] and won ($0.95) with high card Ace (pot not awarded as player cashed out)
Seat 3: pumpedli (big blind) folded before Flop
Seat 4: TrankTank folded before Flop (didn't bet)
Seat 5: partizan_vlg showed [Ad Ks] and won ($0.94) with high card Ace (pot not awarded as player cashed out)
Seat 6: HAL VAGYOK folded before Flop (didn't bet)
Seat 7: Mizepa folded before Flop (didn't bet)
Seat 8: Emrama folded before Flop (didn't bet)
Seat 9: murrie666 folded before Flop (didn't bet)



PokerStars Zoom Hand #216384142622:  Hold'em No Limit ($0.01/$0.02) - 2020/07/13 20:00:54 CET [2020/07/13 14:00:54 ET]
Table 'McNaught' 9-max Seat #1 is the button
Seat 1: BadBeat Bert ($3.90 in chips) 
Seat 2: weiting777 ($1.98 in chips) 
Seat 3: HAL VAGYOK ($4.54 in chips) 
Seat 4: cathousecat ($3.14 in chips) 
Seat 5: BerenKamlost ($2 in chips) 
Seat 6: TheBlade8525 ($3.72 in chips) 
Seat 7: TrankTank ($4.87 in chips) 
Seat 8: Aveena2 ($2.01 in chips) 
Seat 9: airamb.33 ($1 in chips) 
weiting777: posts small blind $0.01
HAL VAGYOK: posts big blind $0.02
*** HOLE CARDS ***
Dealt to TrankTank [7h Jh]
cathousecat: folds 
BerenKamlost: folds 
TheBlade8525: folds 
TrankTank: folds 
Aveena2: folds 
airamb.33: folds 
BadBeat Bert: calls $0.02
weiting777: calls $0.01
HAL VAGYOK: checks 
*** FLOP *** [6c 9c 9h]
weiting777: checks 
HAL VAGYOK: checks 
BadBeat Bert: checks 
*** TURN *** [6c 9c 9h] [3s]
weiting777: checks 
HAL VAGYOK: checks 
BadBeat Bert: checks 
*** RIVER *** [6c 9c 9h 3s] [Qh]
weiting777: checks 
HAL VAGYOK: checks 
BadBeat Bert: checks 
*** SHOW DOWN ***
weiting777: shows [Jd Kd] (a pair of Nines)
HAL VAGYOK: mucks hand 
BadBeat Bert: shows [4h Ah] (a pair of Nines - Ace kicker)
BadBeat Bert collected $0.06 from pot
*** SUMMARY ***
Total pot $0.06 | Rake $0 
Board [6c 9c 9h 3s Qh]
Seat 1: BadBeat Bert (button) showed [4h Ah] and won ($0.06) with a pair of Nines
Seat 2: weiting777 (small blind) showed [Jd Kd] and lost with a pair of Nines
Seat 3: HAL VAGYOK (big blind) mucked [Ts 2h]
Seat 4: cathousecat folded before Flop (didn't bet)
Seat 5: BerenKamlost folded before Flop (didn't bet)
Seat 6: TheBlade8525 folded before Flop (didn't bet)
Seat 7: TrankTank folded before Flop (didn't bet)
Seat 8: Aveena2 folded before Flop (didn't bet)
Seat 9: airamb.33 folded before Flop (didn't bet)



PokerStars Zoom Hand #216384158972:  Hold'em No Limit ($0.01/$0.02) - 2020/07/13 20:01:27 CET [2020/07/13 14:01:27 ET]
Table 'McNaught' 9-max Seat #1 is the button
Seat 1: Juzeppe ($1.24 in chips) 
Seat 2: Djig1t ($2.76 in chips) 
Seat 3: asvdm84 ($2.01 in chips) 
Seat 4: papatomi4 ($2.15 in chips) 
Seat 5: AndronDJ ($7.79 in chips) 
Seat 6: wraggy225 ($5.39 in chips) 
Seat 7: linkk1075 ($8.23 in chips) 
Seat 8: Alla Goa ($0.94 in chips) 
Seat 9: TrankTank ($4.87 in chips) 
Djig1t: posts small blind $0.01
asvdm84: posts big blind $0.02
*** HOLE CARDS ***
Dealt to TrankTank [2c Jd]
papatomi4: folds 
AndronDJ: folds 
wraggy225: raises $0.05 to $0.07
linkk1075: raises $0.21 to $0.28
Alla Goa: folds 
TrankTank: folds 
Juzeppe: folds 
Djig1t: folds 
asvdm84: folds 
wraggy225: calls $0.21
*** FLOP *** [6h 4h Qs]
wraggy225: checks 
linkk1075: bets $0.57
wraggy225: folds 
Uncalled bet ($0.57) returned to linkk1075
linkk1075 collected $0.57 from pot
linkk1075: doesn't show hand 
*** SUMMARY ***
Total pot $0.59 | Rake $0.02 
Board [6h 4h Qs]
Seat 1: Juzeppe (button) folded before Flop (didn't bet)
Seat 2: Djig1t (small blind) folded before Flop
Seat 3: asvdm84 (big blind) folded before Flop
Seat 4: papatomi4 folded before Flop (didn't bet)
Seat 5: AndronDJ folded before Flop (didn't bet)
Seat 6: wraggy225 folded on the Flop
Seat 7: linkk1075 collected ($0.57)
Seat 8: Alla Goa folded before Flop (didn't bet)
Seat 9: TrankTank folded before Flop (didn't bet)



PokerStars Zoom Hand #216384171599:  Hold'em No Limit ($0.01/$0.02) - 2020/07/13 20:01:51 CET [2020/07/13 14:01:51 ET]
Table 'McNaught' 9-max Seat #1 is the button
Seat 1: Gonhar55 ($1.19 in chips) 
Seat 2: erika845 ($1.15 in chips) 
Seat 3: pellion ($2.05 in chips) 
Seat 4: AndronDJ ($7.79 in chips) 
Seat 5: TrankTank ($4.87 in chips) 
Seat 6: dzhonijs_e ($1.99 in chips) 
Seat 7: red_81_2009 ($1.90 in chips) 
Seat 8: pumpedli ($3.09 in chips) 
Seat 9: Brixx440 ($2.78 in chips) 
erika845: posts small blind $0.01
pellion: posts big blind $0.02
*** HOLE CARDS ***
Dealt to TrankTank [Kd 8d]
AndronDJ: folds 
TrankTank: folds 
dzhonijs_e: folds 
red_81_2009: folds 
pumpedli: raises $0.04 to $0.06
Brixx440: folds 
Gonhar55: folds 
erika845: folds 
pellion: folds 
Uncalled bet ($0.04) returned to pumpedli
pumpedli collected $0.05 from pot
pumpedli: doesn't show hand 
*** SUMMARY ***
Total pot $0.05 | Rake $0 
Seat 1: Gonhar55 (button) folded before Flop (didn't bet)
Seat 2: erika845 (small blind) folded before Flop
Seat 3: pellion (big blind) folded before Flop
Seat 4: AndronDJ folded before Flop (didn't bet)
Seat 5: TrankTank folded before Flop (didn't bet)
Seat 6: dzhonijs_e folded before Flop (didn't bet)
Seat 7: red_81_2009 folded before Flop (didn't bet)
Seat 8: pumpedli collected ($0.05)
Seat 9: Brixx440 folded before Flop (didn't bet)



PokerStars Zoom Hand #216384176227:  Hold'em No Limit ($0.01/$0.02) - 2020/07/13 20:02:00 CET [2020/07/13 14:02:00 ET]
Table 'McNaught' 9-max Seat #1 is the button
Seat 1: SUPERNUNO ($2.88 in chips) 
Seat 2: cuzmich500 ($3.73 in chips) 
Seat 3: AndronDJ ($7.79 in chips) 
Seat 4: dzhonijs_e ($1.99 in chips) 
Seat 5: Mizepa ($2.96 in chips) 
Seat 6: TrankTank ($4.87 in chips) 
Seat 7: oanhoanh ($2.50 in chips) 
Seat 8: joehlavicka ($3.08 in chips) 
Seat 9: edeust ($2.25 in chips) 
cuzmich500: posts small blind $0.01
AndronDJ: posts big blind $0.02
*** HOLE CARDS ***
Dealt to TrankTank [Ts 6h]
dzhonijs_e: folds 
Mizepa: folds 
TrankTank: folds 
oanhoanh: folds 
joehlavicka: folds 
edeust: folds 
SUPERNUNO: folds 
cuzmich500: raises $0.03 to $0.05
AndronDJ: folds 
Uncalled bet ($0.03) returned to cuzmich500
cuzmich500 collected $0.04 from pot
cuzmich500: doesn't show hand 
*** SUMMARY ***
Total pot $0.04 | Rake $0 
Seat 1: SUPERNUNO (button) folded before Flop (didn't bet)
Seat 2: cuzmich500 (small blind) collected ($0.04)
Seat 3: AndronDJ (big blind) folded before Flop
Seat 4: dzhonijs_e folded before Flop (didn't bet)
Seat 5: Mizepa folded before Flop (didn't bet)
Seat 6: TrankTank folded before Flop (didn't bet)
Seat 7: oanhoanh folded before Flop (didn't bet)
Seat 8: joehlavicka folded before Flop (didn't bet)
Seat 9: edeust folded before Flop (didn't bet)



PokerStars Zoom Hand #216384147890:  Hold'em No Limit ($0.01/$0.02) - 2020/07/13 20:01:05 CET [2020/07/13 14:01:05 ET]
Table 'McNaught' 9-max Seat #1 is the button
Seat 1: TrankTank ($4.87 in chips) 
Seat 2: givinfree$ ($2 in chips) 
Seat 3: Ronvangen ($1.18 in chips) 
Seat 4: RAMAZEKA88 ($2.09 in chips) 
Seat 5: AdaiRu888 ($2.37 in chips) 
Seat 6: tomashovka55 ($2.43 in chips) 
Seat 7: XHerrTUMNUSX ($2 in chips) 
Seat 8: sayatsemey ($3.14 in chips) 
Seat 9: hurla64 ($3.09 in chips) 
givinfree$: posts small blind $0.01
Ronvangen: posts big blind $0.02
*** HOLE CARDS ***
Dealt to TrankTank [3h Ac]
RAMAZEKA88: folds 
AdaiRu888: raises $0.02 to $0.04
tomashovka55: calls $0.04
XHerrTUMNUSX: calls $0.04
sayatsemey: raises $0.06 to $0.10
hurla64: folds 
TrankTank: folds 
givinfree$: folds 
Ronvangen: calls $0.08
AdaiRu888: calls $0.06
tomashovka55: calls $0.06
XHerrTUMNUSX: calls $0.06
*** FLOP *** [Ks 7c 7h]
Ronvangen: checks 
AdaiRu888: checks 
tomashovka55: checks 
XHerrTUMNUSX: checks 
sayatsemey: checks 
*** TURN *** [Ks 7c 7h] [2s]
Ronvangen: bets $0.20
AdaiRu888: calls $0.20
tomashovka55: folds 
XHerrTUMNUSX: calls $0.20
sayatsemey: folds 
*** RIVER *** [Ks 7c 7h 2s] [8s]
Ronvangen: checks 
AdaiRu888: checks 
XHerrTUMNUSX: bets $1
Ronvangen: calls $0.88 and is all-in
AdaiRu888: folds 
Uncalled bet ($0.12) returned to XHerrTUMNUSX
*** SHOW DOWN ***
XHerrTUMNUSX: shows [Qs Ts] (a flush, King high)
Ronvangen: shows [Kc Td] (two pair, Kings and Sevens)
XHerrTUMNUSX collected $2.77 from pot
*** SUMMARY ***
Total pot $2.87 | Rake $0.10 
Board [Ks 7c 7h 2s 8s]
Seat 1: TrankTank (button) folded before Flop (didn't bet)
Seat 2: givinfree$ (small blind) folded before Flop
Seat 3: Ronvangen (big blind) showed [Kc Td] and lost with two pair, Kings and Sevens
Seat 4: RAMAZEKA88 folded before Flop (didn't bet)
Seat 5: AdaiRu888 folded on the River
Seat 6: tomashovka55 folded on the Turn
Seat 7: XHerrTUMNUSX showed [Qs Ts] and won ($2.77) with a flush, King high
Seat 8: sayatsemey folded on the Turn
Seat 9: hurla64 folded before Flop (didn't bet)



PokerStars Zoom Hand #216384178835:  Hold'em No Limit ($0.01/$0.02) - 2020/07/13 20:02:05 CET [2020/07/13 14:02:05 ET]
Table 'McNaught' 9-max Seat #1 is the button
Seat 1: red_81_2009 ($1.90 in chips) 
Seat 2: Emrama ($1.89 in chips) 
Seat 3: TrankTank ($4.87 in chips) 
Seat 4: oanhoanh ($2.50 in chips) 
Seat 5: dzhonijs_e ($1.99 in chips) 
Seat 6: Brixx440 ($2.78 in chips) 
Seat 7: Mizepa ($2.96 in chips) 
Seat 8: SUPERNUNO ($2.88 in chips) 
Seat 9: sayatsemey ($4.94 in chips) 
Emrama: posts small blind $0.01
TrankTank: posts big blind $0.02
*** HOLE CARDS ***
Dealt to TrankTank [Jh Jc]
oanhoanh: calls $0.02
dzhonijs_e: folds 
Brixx440: folds 
Mizepa: folds 
SUPERNUNO: folds 
sayatsemey: raises $0.04 to $0.06
red_81_2009: folds 
Emrama: folds 
TrankTank: calls $0.04
oanhoanh: calls $0.04
*** FLOP *** [Qs 2s 5d]
TrankTank: checks 
oanhoanh: checks 
sayatsemey: checks 
*** TURN *** [Qs 2s 5d] [9s]
TrankTank: checks 
oanhoanh: checks 
sayatsemey: bets $0.06
TrankTank: calls $0.06
oanhoanh: calls $0.06
*** RIVER *** [Qs 2s 5d 9s] [3s]
TrankTank: checks 
oanhoanh: checks 
sayatsemey: bets $0.22
TrankTank: folds 
oanhoanh: calls $0.22
*** SHOW DOWN ***
sayatsemey: shows [9c Ad] (a pair of Nines)
oanhoanh: shows [Td Js] (a flush, Queen high)
oanhoanh collected $0.78 from pot
*** SUMMARY ***
Total pot $0.81 | Rake $0.03 
Board [Qs 2s 5d 9s 3s]
Seat 1: red_81_2009 (button) folded before Flop (didn't bet)
Seat 2: Emrama (small blind) folded before Flop
Seat 3: TrankTank (big blind) folded on the River
Seat 4: oanhoanh showed [Td Js] and won ($0.78) with a flush, Queen high
Seat 5: dzhonijs_e folded before Flop (didn't bet)
Seat 6: Brixx440 folded before Flop (didn't bet)
Seat 7: Mizepa folded before Flop (didn't bet)
Seat 8: SUPERNUNO folded before Flop (didn't bet)
Seat 9: sayatsemey showed [9c Ad] and lost with a pair of Nines



PokerStars Zoom Hand #216384216529:  Hold'em No Limit ($0.01/$0.02) - 2020/07/13 20:03:12 CET [2020/07/13 14:03:12 ET]
Table 'McNaught' 9-max Seat #1 is the button
Seat 1: givinfree$ ($2.14 in chips) 
Seat 2: TrankTank ($4.75 in chips) 
Seat 3: oanhoanh ($2.94 in chips) 
Seat 4: Emrama ($0.82 in chips) 
Seat 5: SUPERNUNO ($2.78 in chips) 
Seat 6: sayatsemey ($4.59 in chips) 
Seat 7: dorro61966 ($3.42 in chips) 
Seat 8: tomashovka55 ($2.87 in chips) 
Seat 9: avstero ($3.16 in chips) 
TrankTank: posts small blind $0.01
oanhoanh: posts big blind $0.02
*** HOLE CARDS ***
Dealt to TrankTank [Th 9s]
Emrama: folds 
SUPERNUNO: folds 
sayatsemey: raises $0.04 to $0.06
dorro61966: folds 
tomashovka55: folds 
avstero: folds 
givinfree$: folds 
TrankTank: folds 
oanhoanh: folds 
Uncalled bet ($0.04) returned to sayatsemey
sayatsemey collected $0.05 from pot
sayatsemey: doesn't show hand 
*** SUMMARY ***
Total pot $0.05 | Rake $0 
Seat 1: givinfree$ (button) folded before Flop (didn't bet)
Seat 2: TrankTank (small blind) folded before Flop
Seat 3: oanhoanh (big blind) folded before Flop
Seat 4: Emrama folded before Flop (didn't bet)
Seat 5: SUPERNUNO folded before Flop (didn't bet)
Seat 6: sayatsemey collected ($0.05)
Seat 7: dorro61966 folded before Flop (didn't bet)
Seat 8: tomashovka55 folded before Flop (didn't bet)
Seat 9: avstero folded before Flop (didn't bet)



PokerStars Zoom Hand #216384211353:  Hold'em No Limit ($0.01/$0.02) - 2020/07/13 20:03:03 CET [2020/07/13 14:03:03 ET]
Table 'McNaught' 9-max Seat #1 is the button
Seat 1: Luisk2293 ($2.09 in chips) 
Seat 2: BEUXA ($2.51 in chips) 
Seat 3: airamb.33 ($1.69 in chips) 
Seat 4: givinfree$ ($2.14 in chips) 
Seat 5: map0128 ($2.40 in chips) 
Seat 6: linkk1075 ($8.49 in chips) 
Seat 7: Aveena2 ($2.01 in chips) 
Seat 8: TrankTank ($4.75 in chips) 
Seat 9: red_81_2009 ($1.87 in chips) 
BEUXA: posts small blind $0.01
airamb.33: posts big blind $0.02
*** HOLE CARDS ***
Dealt to TrankTank [6d 3d]
givinfree$: folds 
map0128: folds 
linkk1075: folds 
Aveena2: folds 
TrankTank: folds 
red_81_2009: folds 
Luisk2293: raises $0.02 to $0.04
BEUXA: calls $0.03
airamb.33: folds 
*** FLOP *** [9c 9h 7s]
BEUXA: checks 
Luisk2293: checks 
*** TURN *** [9c 9h 7s] [7d]
BEUXA: bets $0.04
Luisk2293: calls $0.04
*** RIVER *** [9c 9h 7s 7d] [3s]
BEUXA: bets $0.08
Luisk2293: calls $0.08
*** SHOW DOWN ***
BEUXA: shows [Ts Th] (two pair, Tens and Nines)
Luisk2293: mucks hand 
BEUXA collected $0.33 from pot
*** SUMMARY ***
Total pot $0.34 | Rake $0.01 
Board [9c 9h 7s 7d 3s]
Seat 1: Luisk2293 (button) mucked [4d Ac]
Seat 2: BEUXA (small blind) showed [Ts Th] and won ($0.33) with two pair, Tens and Nines
Seat 3: airamb.33 (big blind) folded before Flop
Seat 4: givinfree$ folded before Flop (didn't bet)
Seat 5: map0128 folded before Flop (didn't bet)
Seat 6: linkk1075 folded before Flop (didn't bet)
Seat 7: Aveena2 folded before Flop (didn't bet)
Seat 8: TrankTank folded before Flop (didn't bet)
Seat 9: red_81_2009 folded before Flop (didn't bet)



PokerStars Zoom Hand #216384225403:  Hold'em No Limit ($0.01/$0.02) - 2020/07/13 20:03:28 CET [2020/07/13 14:03:28 ET]
Table 'McNaught' 9-max Seat #1 is the button
Seat 1: TrankTank ($4.74 in chips) 
Seat 2: Djig1t ($2.21 in chips) 
Seat 3: Aveena2 ($3.52 in chips) 
Seat 4: pellion ($2.48 in chips) 
Seat 5: joehlavicka ($2.49 in chips) 
Seat 6: BerenKamlost ($1.47 in chips) 
Seat 7: oanhoanh ($2.91 in chips) 
Seat 8: papatomi4 ($2.78 in chips) 
Seat 9: Sarahi P. ($2 in chips) 
Djig1t: posts small blind $0.01
Aveena2: posts big blind $0.02
*** HOLE CARDS ***
Dealt to TrankTank [8c 3h]
pellion: folds 
joehlavicka: folds 
BerenKamlost: calls $0.02
oanhoanh: calls $0.02
papatomi4: raises $0.09 to $0.11
Sarahi P.: folds 
TrankTank: folds 
Djig1t: folds 
Aveena2: folds 
BerenKamlost: calls $0.09
oanhoanh: folds 
*** FLOP *** [4s Ah 2c]
BerenKamlost: checks 
papatomi4: bets $0.26
BerenKamlost: folds 
Uncalled bet ($0.26) returned to papatomi4
papatomi4 collected $0.26 from pot
papatomi4: doesn't show hand 
*** SUMMARY ***
Total pot $0.27 | Rake $0.01 
Board [4s Ah 2c]
Seat 1: TrankTank (button) folded before Flop (didn't bet)
Seat 2: Djig1t (small blind) folded before Flop
Seat 3: Aveena2 (big blind) folded before Flop
Seat 4: pellion folded before Flop (didn't bet)
Seat 5: joehlavicka folded before Flop (didn't bet)
Seat 6: BerenKamlost folded on the Flop
Seat 7: oanhoanh folded before Flop
Seat 8: papatomi4 collected ($0.26)
Seat 9: Sarahi P. folded before Flop (didn't bet)



PokerStars Zoom Hand #216384247999:  Hold'em No Limit ($0.01/$0.02) - 2020/07/13 20:04:07 CET [2020/07/13 14:04:07 ET]
Table 'McNaught' 9-max Seat #1 is the button
Seat 1: cathousecat ($4.17 in chips) 
Seat 2: Mara6111 ($3.59 in chips) 
Seat 3: AdaiRu888 ($3.05 in chips) 
Seat 4: jonick17 ($0.77 in chips) 
Seat 5: HAL VAGYOK ($2 in chips) 
Seat 6: Luisk2293 ($4.04 in chips) 
Seat 7: pisqnek ($3.10 in chips) 
Seat 8: hurla64 ($12.61 in chips) 
Seat 9: TrankTank ($4.74 in chips) 
Mara6111: posts small blind $0.01
AdaiRu888: posts big blind $0.02
*** HOLE CARDS ***
Dealt to TrankTank [8d Js]
jonick17: raises $0.05 to $0.07
HAL VAGYOK: calls $0.07
Luisk2293: folds 
pisqnek: folds 
hurla64: folds 
TrankTank: folds 
cathousecat: folds 
Mara6111: folds 
AdaiRu888: folds 
*** FLOP *** [9h Kh 8s]
jonick17: checks 
HAL VAGYOK: bets $0.16
jonick17: calls $0.16
*** TURN *** [9h Kh 8s] [9c]
jonick17: checks 
HAL VAGYOK: bets $0.47
jonick17: raises $0.07 to $0.54 and is all-in
HAL VAGYOK: calls $0.07
*** RIVER *** [9h Kh 8s 9c] [2s]
*** SHOW DOWN ***
jonick17: shows [Ac Ah] (two pair, Aces and Nines)
HAL VAGYOK: shows [Kd Qd] (two pair, Kings and Nines)
jonick17 collected $1.52 from pot
*** SUMMARY ***
Total pot $1.57 | Rake $0.05 
Board [9h Kh 8s 9c 2s]
Seat 1: cathousecat (button) folded before Flop (didn't bet)
Seat 2: Mara6111 (small blind) folded before Flop
Seat 3: AdaiRu888 (big blind) folded before Flop
Seat 4: jonick17 showed [Ac Ah] and won ($1.52) with two pair, Aces and Nines
Seat 5: HAL VAGYOK showed [Kd Qd] and lost with two pair, Kings and Nines
Seat 6: Luisk2293 folded before Flop (didn't bet)
Seat 7: pisqnek folded before Flop (didn't bet)
Seat 8: hurla64 folded before Flop (didn't bet)
Seat 9: TrankTank folded before Flop (didn't bet)



PokerStars Zoom Hand #216384229651:  Hold'em No Limit ($0.01/$0.02) - 2020/07/13 20:03:35 CET [2020/07/13 14:03:35 ET]
Table 'McNaught' 9-max Seat #1 is the button
Seat 1: Sarahi P. ($2 in chips) 
Seat 2: RodRuenRus ($2 in chips) 
Seat 3: sczurek19681 ($1.38 in chips) 
Seat 4: AndronDJ ($2.59 in chips) 
Seat 5: tomashovka55 ($2.87 in chips) 
Seat 6: TrankTank ($4.74 in chips) 
Seat 7: FelixFerrari ($2.13 in chips) 
Seat 8: snow9001 ($4.33 in chips) 
Seat 9: grunge&punk ($2.76 in chips) 
RodRuenRus: posts small blind $0.01
sczurek19681: posts big blind $0.02
*** HOLE CARDS ***
Dealt to TrankTank [Qh Th]
AndronDJ: folds 
tomashovka55: folds 
TrankTank: folds 
FelixFerrari: raises $0.02 to $0.04
snow9001: raises $0.09 to $0.13
grunge&punk: folds 
Sarahi P.: folds 
RodRuenRus: folds 
sczurek19681: folds 
FelixFerrari: calls $0.09
*** FLOP *** [8h 5h 3c]
FelixFerrari: checks 
snow9001: checks 
*** TURN *** [8h 5h 3c] [4c]
FelixFerrari: bets $0.14
snow9001: folds 
Uncalled bet ($0.14) returned to FelixFerrari
FelixFerrari collected $0.28 from pot
FelixFerrari: doesn't show hand 
*** SUMMARY ***
Total pot $0.29 | Rake $0.01 
Board [8h 5h 3c 4c]
Seat 1: Sarahi P. (button) folded before Flop (didn't bet)
Seat 2: RodRuenRus (small blind) folded before Flop
Seat 3: sczurek19681 (big blind) folded before Flop
Seat 4: AndronDJ folded before Flop (didn't bet)
Seat 5: tomashovka55 folded before Flop (didn't bet)
Seat 6: TrankTank folded before Flop (didn't bet)
Seat 7: FelixFerrari collected ($0.28)
Seat 8: snow9001 folded on the Turn
Seat 9: grunge&punk folded before Flop (didn't bet)



PokerStars Zoom Hand #216384240520:  Hold'em No Limit ($0.01/$0.02) - 2020/07/13 20:03:54 CET [2020/07/13 14:03:54 ET]
Table 'McNaught' 9-max Seat #1 is the button
Seat 1: Zlata Jama ($2.35 in chips) 
Seat 2: Armtone ($4.17 in chips) 
Seat 3: hurla64 ($2.34 in chips) 
Seat 4: dark33.rus ($1.32 in chips) 
Seat 5: Elvis ah ha ($5.44 in chips) 
Seat 6: Iron208 ($4.88 in chips) 
Seat 7: TrankTank ($4.74 in chips) 
Seat 8: red_81_2009 ($1.94 in chips) 
Seat 9: AndronDJ ($7.88 in chips) 
Armtone: posts small blind $0.01
hurla64: posts big blind $0.02
*** HOLE CARDS ***
Dealt to TrankTank [5s 8c]
dark33.rus: folds 
Elvis ah ha: calls $0.02
Iron208: folds 
TrankTank: folds 
red_81_2009: folds 
AndronDJ: calls $0.02
Zlata Jama: folds 
Armtone: calls $0.01
hurla64: checks 
*** FLOP *** [2s 3c 3d]
Armtone: checks 
hurla64: checks 
Elvis ah ha: bets $0.04
AndronDJ: folds 
Armtone: calls $0.04
hurla64: folds 
*** TURN *** [2s 3c 3d] [9d]
Armtone: checks 
Elvis ah ha: bets $0.08
Armtone: calls $0.08
*** RIVER *** [2s 3c 3d 9d] [6d]
Armtone: checks 
Elvis ah ha: bets $0.16
Armtone: calls $0.16
*** SHOW DOWN ***
Elvis ah ha: shows [7c 7d] (two pair, Sevens and Threes)
Armtone: shows [Kh 3h] (three of a kind, Threes)
Armtone collected $0.62 from pot
*** SUMMARY ***
Total pot $0.64 | Rake $0.02 
Board [2s 3c 3d 9d 6d]
Seat 1: Zlata Jama (button) folded before Flop (didn't bet)
Seat 2: Armtone (small blind) showed [Kh 3h] and won ($0.62) with three of a kind, Threes
Seat 3: hurla64 (big blind) folded on the Flop
Seat 4: dark33.rus folded before Flop (didn't bet)
Seat 5: Elvis ah ha showed [7c 7d] and lost with two pair, Sevens and Threes
Seat 6: Iron208 folded before Flop (didn't bet)
Seat 7: TrankTank folded before Flop (didn't bet)
Seat 8: red_81_2009 folded before Flop (didn't bet)
Seat 9: AndronDJ folded on the Flop



PokerStars Zoom Hand #216384259696:  Hold'em No Limit ($0.01/$0.02) - 2020/07/13 20:04:27 CET [2020/07/13 14:04:27 ET]
Table 'McNaught' 9-max Seat #1 is the button
Seat 1: oanhoanh ($2.92 in chips) 
Seat 2: Mizepa ($2 in chips) 
Seat 3: Djig1t ($2 in chips) 
Seat 4: TrankTank ($4.74 in chips) 
Seat 5: hurla64 ($3.95 in chips) 
Seat 6: pisqnek ($3.10 in chips) 
Seat 7: joehlavicka ($2.49 in chips) 
Seat 8: Iron208 ($4.87 in chips) 
Seat 9: RodRuenRus ($2 in chips) 
Mizepa: posts small blind $0.01
Djig1t: posts big blind $0.02
*** HOLE CARDS ***
Dealt to TrankTank [2s Kh]
TrankTank: folds 
hurla64: folds 
pisqnek: folds 
joehlavicka: folds 
Iron208: raises $0.03 to $0.05
RodRuenRus: folds 
oanhoanh: folds 
Mizepa: folds 
Djig1t: folds 
Uncalled bet ($0.03) returned to Iron208
Iron208 collected $0.05 from pot
Iron208: doesn't show hand 
*** SUMMARY ***
Total pot $0.05 | Rake $0 
Seat 1: oanhoanh (button) folded before Flop (didn't bet)
Seat 2: Mizepa (small blind) folded before Flop
Seat 3: Djig1t (big blind) folded before Flop
Seat 4: TrankTank folded before Flop (didn't bet)
Seat 5: hurla64 folded before Flop (didn't bet)
Seat 6: pisqnek folded before Flop (didn't bet)
Seat 7: joehlavicka folded before Flop (didn't bet)
Seat 8: Iron208 collected ($0.05)
Seat 9: RodRuenRus folded before Flop (didn't bet)



PokerStars Zoom Hand #216384255005:  Hold'em No Limit ($0.01/$0.02) - 2020/07/13 20:04:19 CET [2020/07/13 14:04:19 ET]
Table 'McNaught' 9-max Seat #1 is the button
Seat 1: 5gdangers ($10.73 in chips) 
Seat 2: BadBeat Bert ($3.73 in chips) 
Seat 3: cuzmich500 ($1.05 in chips) 
Seat 4: AdaiRu888 ($3.03 in chips) 
Seat 5: TrankTank ($4.74 in chips) 
Seat 6: try1fucan ($4.82 in chips) 
Seat 7: Armtone ($3.26 in chips) 
Seat 8: Fishfood87 ($2 in chips) 
Seat 9: linkk1075 ($9.60 in chips) 
BadBeat Bert: posts small blind $0.01
cuzmich500: posts big blind $0.02
*** HOLE CARDS ***
Dealt to TrankTank [Kh 2c]
AdaiRu888: folds 
TrankTank: folds 
try1fucan: folds 
Armtone: folds 
Fishfood87: raises $0.04 to $0.06
linkk1075: folds 
5gdangers: calls $0.06
BadBeat Bert: folds 
cuzmich500: folds 
*** FLOP *** [Td 3d Ad]
Fishfood87: checks 
5gdangers: bets $0.07
Fishfood87: folds 
Uncalled bet ($0.07) returned to 5gdangers
5gdangers collected $0.14 from pot
5gdangers: doesn't show hand 
*** SUMMARY ***
Total pot $0.15 | Rake $0.01 
Board [Td 3d Ad]
Seat 1: 5gdangers (button) collected ($0.14)
Seat 2: BadBeat Bert (small blind) folded before Flop
Seat 3: cuzmich500 (big blind) folded before Flop
Seat 4: AdaiRu888 folded before Flop (didn't bet)
Seat 5: TrankTank folded before Flop (didn't bet)
Seat 6: try1fucan folded before Flop (didn't bet)
Seat 7: Armtone folded before Flop (didn't bet)
Seat 8: Fishfood87 folded on the Flop
Seat 9: linkk1075 folded before Flop (didn't bet)



PokerStars Zoom Hand #216384262668:  Hold'em No Limit ($0.01/$0.02) - 2020/07/13 20:04:32 CET [2020/07/13 14:04:32 ET]
Table 'McNaught' 9-max Seat #1 is the button
Seat 1: RodRuenRus ($2 in chips) 
Seat 2: XHerrTUMNUSX ($3.57 in chips) 
Seat 3: TrankTank ($4.74 in chips) 
Seat 4: Herman1978 ($1.27 in chips) 
Seat 5: oanhoanh ($2.92 in chips) 
Seat 6: givinfree$ ($2.03 in chips) 
Seat 7: mathplayer ($1.94 in chips) 
Seat 8: Hese_8 ($1.22 in chips) 
Seat 9: laureano290 ($2.03 in chips) 
XHerrTUMNUSX: posts small blind $0.01
TrankTank: posts big blind $0.02
*** HOLE CARDS ***
Dealt to TrankTank [9s Qd]
Herman1978: calls $0.02
oanhoanh: folds 
givinfree$: folds 
mathplayer: folds 
Hese_8: folds 
laureano290: folds 
RodRuenRus: folds 
XHerrTUMNUSX: folds 
TrankTank: checks 
*** FLOP *** [7c 9c Tc]
TrankTank: checks 
Herman1978: checks 
*** TURN *** [7c 9c Tc] [Ah]
TrankTank: checks 
Herman1978: checks 
*** RIVER *** [7c 9c Tc Ah] [Jc]
TrankTank: checks 
Herman1978: checks 
*** SHOW DOWN ***
TrankTank: shows [9s Qd] (a pair of Nines)
Herman1978: shows [9h 8d] (a straight, Seven to Jack)
Herman1978 collected $0.05 from pot
*** SUMMARY ***
Total pot $0.05 | Rake $0 
Board [7c 9c Tc Ah Jc]
Seat 1: RodRuenRus (button) folded before Flop (didn't bet)
Seat 2: XHerrTUMNUSX (small blind) folded before Flop
Seat 3: TrankTank (big blind) showed [9s Qd] and lost with a pair of Nines
Seat 4: Herman1978 showed [9h 8d] and won ($0.05) with a straight, Seven to Jack
Seat 5: oanhoanh folded before Flop (didn't bet)
Seat 6: givinfree$ folded before Flop (didn't bet)
Seat 7: mathplayer folded before Flop (didn't bet)
Seat 8: Hese_8 folded before Flop (didn't bet)
Seat 9: laureano290 folded before Flop (didn't bet)



PokerStars Zoom Hand #216384295929:  Hold'em No Limit ($0.01/$0.02) - 2020/07/13 20:05:29 CET [2020/07/13 14:05:29 ET]
Table 'McNaught' 9-max Seat #1 is the button
Seat 1: Fishfood87 ($2 in chips) 
Seat 2: TrankTank ($4.72 in chips) 
Seat 3: cuzmich500 ($2.28 in chips) 
Seat 4: givinfree$ ($2 in chips) 
Seat 5: bohseronkel ($1.97 in chips) 
Seat 6: erika845 ($1.03 in chips) 
Seat 7: Luisk2293 ($3.97 in chips) 
Seat 8: pumpedli ($3.42 in chips) 
Seat 9: Aveena2 ($2.06 in chips) 
TrankTank: posts small blind $0.01
cuzmich500: posts big blind $0.02
*** HOLE CARDS ***
Dealt to TrankTank [4h 4d]
givinfree$: raises $0.04 to $0.06
bohseronkel: folds 
erika845: folds 
Luisk2293: folds 
pumpedli: folds 
Aveena2: folds 
Fishfood87: folds 
TrankTank: calls $0.05
cuzmich500: folds 
*** FLOP *** [Qd 8s Qc]
TrankTank: checks 
givinfree$: checks 
*** TURN *** [Qd 8s Qc] [As]
TrankTank: checks 
givinfree$: checks 
*** RIVER *** [Qd 8s Qc As] [5c]
TrankTank: checks 
givinfree$: checks 
*** SHOW DOWN ***
TrankTank: shows [4h 4d] (two pair, Queens and Fours)
givinfree$: shows [6h 6c] (two pair, Queens and Sixes)
givinfree$ collected $0.14 from pot
*** SUMMARY ***
Total pot $0.14 | Rake $0 
Board [Qd 8s Qc As 5c]
Seat 1: Fishfood87 (button) folded before Flop (didn't bet)
Seat 2: TrankTank (small blind) showed [4h 4d] and lost with two pair, Queens and Fours
Seat 3: cuzmich500 (big blind) folded before Flop
Seat 4: givinfree$ showed [6h 6c] and won ($0.14) with two pair, Queens and Sixes
Seat 5: bohseronkel folded before Flop (didn't bet)
Seat 6: erika845 folded before Flop (didn't bet)
Seat 7: Luisk2293 folded before Flop (didn't bet)
Seat 8: pumpedli folded before Flop (didn't bet)
Seat 9: Aveena2 folded before Flop (didn't bet)



PokerStars Zoom Hand #216384287291:  Hold'em No Limit ($0.01/$0.02) - 2020/07/13 20:05:14 CET [2020/07/13 14:05:14 ET]
Table 'McNaught' 9-max Seat #1 is the button
Seat 1: AndronDJ ($2.56 in chips) 
Seat 2: snow9001 ($2.70 in chips) 
Seat 3: Aveena2 ($2.08 in chips) 
Seat 4: j4man2000 ($1.39 in chips) 
Seat 5: TrankTank ($4.72 in chips) 
Seat 6: Herman1978 ($1.30 in chips) 
Seat 7: sayatsemey ($2.80 in chips) 
Seat 8: hurla64 ($1.99 in chips) 
Seat 9: pisqnek ($5.53 in chips) 
snow9001: posts small blind $0.01
Aveena2: posts big blind $0.02
*** HOLE CARDS ***
Dealt to TrankTank [6s 3d]
j4man2000: calls $0.02
TrankTank: folds 
Herman1978: raises $0.07 to $0.09
sayatsemey: folds 
hurla64: calls $0.09
pisqnek: folds 
AndronDJ: calls $0.09
j4man2000 is disconnected 
snow9001: folds 
Aveena2: folds 
j4man2000: folds 
*** FLOP *** [4c 2c 5d]
Herman1978: checks 
hurla64: bets $0.17
AndronDJ: calls $0.17
Herman1978: folds 
*** TURN *** [4c 2c 5d] [Qh]
hurla64: bets $0.35
AndronDJ: calls $0.35
*** RIVER *** [4c 2c 5d Qh] [3h]
hurla64: bets $0.46
AndronDJ: calls $0.46
*** SHOW DOWN ***
hurla64: shows [Js Jd] (a pair of Jacks)
AndronDJ: shows [Ad Qd] (a straight, Ace to Five)
AndronDJ collected $2.20 from pot
*** SUMMARY ***
Total pot $2.28 | Rake $0.08 
Board [4c 2c 5d Qh 3h]
Seat 1: AndronDJ (button) showed [Ad Qd] and won ($2.20) with a straight, Ace to Five
Seat 2: snow9001 (small blind) folded before Flop
Seat 3: Aveena2 (big blind) folded before Flop
Seat 4: j4man2000 folded before Flop
Seat 5: TrankTank folded before Flop (didn't bet)
Seat 6: Herman1978 folded on the Flop
Seat 7: sayatsemey folded before Flop (didn't bet)
Seat 8: hurla64 showed [Js Jd] and lost with a pair of Jacks
Seat 9: pisqnek folded before Flop (didn't bet)



PokerStars Zoom Hand #216384289571:  Hold'em No Limit ($0.01/$0.02) - 2020/07/13 20:05:18 CET [2020/07/13 14:05:18 ET]
Table 'McNaught' 9-max Seat #1 is the button
Seat 1: dimitriusDZ ($2 in chips) 
Seat 2: Skvo1881 ($1.06 in chips) 
Seat 3: ALF_70 ($1.74 in chips) 
Seat 4: red_81_2009 ($1.92 in chips) 
Seat 5: Brixx440 ($2 in chips) 
Seat 6: edeust ($2.58 in chips) 
Seat 7: joehlavicka ($2.21 in chips) 
Seat 8: TrankTank ($4.72 in chips) 
Seat 9: Mizepa ($2 in chips) 
Skvo1881: posts small blind $0.01
ALF_70: posts big blind $0.02
*** HOLE CARDS ***
Dealt to TrankTank [4h 2d]
red_81_2009: folds 
Brixx440: folds 
edeust: folds 
joehlavicka: folds 
TrankTank: folds 
Mizepa: folds 
dimitriusDZ: raises $0.03 to $0.05
Skvo1881: calls $0.04
ALF_70: calls $0.03
*** FLOP *** [8c 4c 5s]
Skvo1881: checks 
ALF_70: checks 
dimitriusDZ: bets $0.09
Skvo1881: calls $0.09
ALF_70: folds 
*** TURN *** [8c 4c 5s] [Ks]
Skvo1881: checks 
dimitriusDZ: checks 
*** RIVER *** [8c 4c 5s Ks] [7s]
Skvo1881: checks 
dimitriusDZ: checks 
*** SHOW DOWN ***
Skvo1881: shows [5h 2c] (a pair of Fives)
dimitriusDZ: mucks hand 
Skvo1881 collected $0.32 from pot
*** SUMMARY ***
Total pot $0.33 | Rake $0.01 
Board [8c 4c 5s Ks 7s]
Seat 1: dimitriusDZ (button) mucked [Qc Ad]
Seat 2: Skvo1881 (small blind) showed [5h 2c] and won ($0.32) with a pair of Fives
Seat 3: ALF_70 (big blind) folded on the Flop
Seat 4: red_81_2009 folded before Flop (didn't bet)
Seat 5: Brixx440 folded before Flop (didn't bet)
Seat 6: edeust folded before Flop (didn't bet)
Seat 7: joehlavicka folded before Flop (didn't bet)
Seat 8: TrankTank folded before Flop (didn't bet)
Seat 9: Mizepa folded before Flop (didn't bet)



PokerStars Zoom Hand #216384331102:  Hold'em No Limit ($0.01/$0.02) - 2020/07/13 20:06:29 CET [2020/07/13 14:06:29 ET]
Table 'McNaught' 9-max Seat #1 is the button
Seat 1: TrankTank ($4.66 in chips) 
Seat 2: erika845 ($0.95 in chips) 
Seat 3: SUPERNUNO ($2.94 in chips) 
Seat 4: pumpedli ($2.77 in chips) 
Seat 5: Iron208 ($2.15 in chips) 
Seat 6: 5gdangers ($10.87 in chips) 
Seat 7: pellion ($1.94 in chips) 
Seat 8: mathplayer ($2.08 in chips) 
Seat 9: Luisk2293 ($3.81 in chips) 
erika845: posts small blind $0.01
SUPERNUNO: posts big blind $0.02
*** HOLE CARDS ***
Dealt to TrankTank [5h Ks]
pumpedli: folds 
Iron208: folds 
5gdangers: folds 
pellion: folds 
mathplayer: folds 
Luisk2293: folds 
TrankTank: folds 
erika845: folds 
Uncalled bet ($0.01) returned to SUPERNUNO
SUPERNUNO collected $0.02 from pot
SUPERNUNO: doesn't show hand 
*** SUMMARY ***
Total pot $0.02 | Rake $0 
Seat 1: TrankTank (button) folded before Flop (didn't bet)
Seat 2: erika845 (small blind) folded before Flop
Seat 3: SUPERNUNO (big blind) collected ($0.02)
Seat 4: pumpedli folded before Flop (didn't bet)
Seat 5: Iron208 folded before Flop (didn't bet)
Seat 6: 5gdangers folded before Flop (didn't bet)
Seat 7: pellion folded before Flop (didn't bet)
Seat 8: mathplayer folded before Flop (didn't bet)
Seat 9: Luisk2293 folded before Flop (didn't bet)



PokerStars Zoom Hand #216384337063:  Hold'em No Limit ($0.01/$0.02) - 2020/07/13 20:06:39 CET [2020/07/13 14:06:39 ET]
Table 'McNaught' 9-max Seat #1 is the button
Seat 1: Emrama ($1.62 in chips) 
Seat 2: Mizepa ($2 in chips) 
Seat 3: tomashovka55 ($2.30 in chips) 
Seat 4: vasyara26 ($3.94 in chips) 
Seat 5: Mara6111 ($3.45 in chips) 
Seat 6: TrankTank ($4.66 in chips) 
Seat 7: partizan_vlg ($1.44 in chips) 
Seat 8: dzhonijs_e ($1.97 in chips) 
Seat 9: pellion ($1.94 in chips) 
Mizepa: posts small blind $0.01
tomashovka55: posts big blind $0.02
*** HOLE CARDS ***
Dealt to TrankTank [8s Ah]
vasyara26: folds 
Mara6111: folds 
TrankTank: folds 
partizan_vlg: folds 
dzhonijs_e: folds 
pellion: folds 
Emrama: folds 
Mizepa: raises $0.04 to $0.06
tomashovka55: folds 
Uncalled bet ($0.04) returned to Mizepa
Mizepa collected $0.04 from pot
Mizepa: doesn't show hand 
*** SUMMARY ***
Total pot $0.04 | Rake $0 
Seat 1: Emrama (button) folded before Flop (didn't bet)
Seat 2: Mizepa (small blind) collected ($0.04)
Seat 3: tomashovka55 (big blind) folded before Flop
Seat 4: vasyara26 folded before Flop (didn't bet)
Seat 5: Mara6111 folded before Flop (didn't bet)
Seat 6: TrankTank folded before Flop (didn't bet)
Seat 7: partizan_vlg folded before Flop (didn't bet)
Seat 8: dzhonijs_e folded before Flop (didn't bet)
Seat 9: pellion folded before Flop (didn't bet)



PokerStars Zoom Hand #216384324718:  Hold'em No Limit ($0.01/$0.02) - 2020/07/13 20:06:18 CET [2020/07/13 14:06:18 ET]
Table 'McNaught' 9-max Seat #1 is the button
Seat 1: RodRuenRus ($2 in chips) 
Seat 2: bogdan_k_ua ($2.89 in chips) 
Seat 3: wraggy225 ($2.87 in chips) 
Seat 4: KKwstas ($1.83 in chips) 
Seat 5: tomashovka55 ($2.89 in chips) 
Seat 6: hurla64 ($12.58 in chips) 
Seat 7: mathplayer ($1.59 in chips) 
Seat 8: HAL VAGYOK ($3.04 in chips) 
Seat 9: TrankTank ($4.66 in chips) 
bogdan_k_ua: posts small blind $0.01
wraggy225: posts big blind $0.02
*** HOLE CARDS ***
Dealt to TrankTank [2s 5s]
KKwstas: raises $0.02 to $0.04
tomashovka55: folds 
hurla64: folds 
mathplayer: folds 
HAL VAGYOK: folds 
TrankTank: folds 
RodRuenRus: folds 
bogdan_k_ua: raises $0.10 to $0.14
wraggy225: calls $0.12
KKwstas: folds 
*** FLOP *** [Qd 2c 6h]
bogdan_k_ua: bets $0.24
wraggy225: calls $0.24
*** TURN *** [Qd 2c 6h] [Ks]
bogdan_k_ua: checks 
wraggy225: checks 
*** RIVER *** [Qd 2c 6h Ks] [8h]
bogdan_k_ua: checks 
wraggy225: checks 
*** SHOW DOWN ***
bogdan_k_ua: shows [Qs Ac] (a pair of Queens)
wraggy225: mucks hand 
bogdan_k_ua collected $0.77 from pot
*** SUMMARY ***
Total pot $0.80 | Rake $0.03 
Board [Qd 2c 6h Ks 8h]
Seat 1: RodRuenRus (button) folded before Flop (didn't bet)
Seat 2: bogdan_k_ua (small blind) showed [Qs Ac] and won ($0.77) with a pair of Queens
Seat 3: wraggy225 (big blind) mucked [Td Ts]
Seat 4: KKwstas folded before Flop
Seat 5: tomashovka55 folded before Flop (didn't bet)
Seat 6: hurla64 folded before Flop (didn't bet)
Seat 7: mathplayer folded before Flop (didn't bet)
Seat 8: HAL VAGYOK folded before Flop (didn't bet)
Seat 9: TrankTank folded before Flop (didn't bet)



PokerStars Zoom Hand #216384342262:  Hold'em No Limit ($0.01/$0.02) - 2020/07/13 20:06:48 CET [2020/07/13 14:06:48 ET]
Table 'McNaught' 9-max Seat #1 is the button
Seat 1: buendiablo ($4.38 in chips) 
Seat 2: grimmix ($1.98 in chips) 
Seat 3: grunge&punk ($2.69 in chips) 
Seat 4: Mara6111 ($3.45 in chips) 
Seat 5: AdaiRu888 ($2.97 in chips) 
Seat 6: RodRuenRus ($2.03 in chips) 
Seat 7: TrankTank ($4.66 in chips) 
Seat 8: papatomi4 ($2.96 in chips) 
Seat 9: laureano290 ($2 in chips) 
grimmix: posts small blind $0.01
grunge&punk: posts big blind $0.02
*** HOLE CARDS ***
Dealt to TrankTank [Jc Qd]
Mara6111: folds 
AdaiRu888: folds 
RodRuenRus: folds 
TrankTank: raises $0.04 to $0.06
papatomi4: calls $0.06
laureano290: folds 
buendiablo: folds 
grimmix: calls $0.05
grunge&punk: folds 
*** FLOP *** [Kh Qs Td]
grimmix: bets $0.08
TrankTank: calls $0.08
papatomi4: folds 
*** TURN *** [Kh Qs Td] [7s]
grimmix: bets $0.18
TrankTank: folds 
Uncalled bet ($0.18) returned to grimmix
grimmix collected $0.35 from pot
grimmix: doesn't show hand 
*** SUMMARY ***
Total pot $0.36 | Rake $0.01 
Board [Kh Qs Td 7s]
Seat 1: buendiablo (button) folded before Flop (didn't bet)
Seat 2: grimmix (small blind) collected ($0.35)
Seat 3: grunge&punk (big blind) folded before Flop
Seat 4: Mara6111 folded before Flop (didn't bet)
Seat 5: AdaiRu888 folded before Flop (didn't bet)
Seat 6: RodRuenRus folded before Flop (didn't bet)
Seat 7: TrankTank folded on the Turn
Seat 8: papatomi4 folded on the Flop
Seat 9: laureano290 folded before Flop (didn't bet)



PokerStars Zoom Hand #216384373427:  Hold'em No Limit ($0.01/$0.02) - 2020/07/13 20:07:41 CET [2020/07/13 14:07:41 ET]
Table 'McNaught' 9-max Seat #1 is the button
Seat 1: cuzmich500 ($1.22 in chips) 
Seat 2: AndronDJ ($7.69 in chips) 
Seat 3: hotvan ($1.53 in chips) 
Seat 4: Luisk2293 ($3.79 in chips) 
Seat 5: givinfree$ ($2.23 in chips) 
Seat 6: TrankTank ($4.52 in chips) 
Seat 7: Aveena2 ($4.25 in chips) 
Seat 8: Brixx440 ($2 in chips) 
Seat 9: Prrrronya ($1.77 in chips) 
AndronDJ: posts small blind $0.01
hotvan: posts big blind $0.02
*** HOLE CARDS ***
Dealt to TrankTank [2s Qh]
Luisk2293: folds 
givinfree$: folds 
TrankTank: folds 
Aveena2: folds 
Brixx440: folds 
Prrrronya: folds 
cuzmich500: folds 
AndronDJ: folds 
Uncalled bet ($0.01) returned to hotvan
hotvan collected $0.02 from pot
hotvan: doesn't show hand 
*** SUMMARY ***
Total pot $0.02 | Rake $0 
Seat 1: cuzmich500 (button) folded before Flop (didn't bet)
Seat 2: AndronDJ (small blind) folded before Flop
Seat 3: hotvan (big blind) collected ($0.02)
Seat 4: Luisk2293 folded before Flop (didn't bet)
Seat 5: givinfree$ folded before Flop (didn't bet)
Seat 6: TrankTank folded before Flop (didn't bet)
Seat 7: Aveena2 folded before Flop (didn't bet)
Seat 8: Brixx440 folded before Flop (didn't bet)
Seat 9: Prrrronya folded before Flop (didn't bet)



